Date,Reference,Value Date,Debit,Credit,Balance,Remarks
10-Jan-18,,10-Jan-18,,"56,000.00","97,528.86",CHEQUE DEPOSIT CHQ DEP FRM KOTS CATERING NIG LTD TO MC ALISTER NIG LTD
10-Jan-18,0,10-Jan-18,50,,"97,478.86",STAMP DUTY CHARGE 10012018 STAMP DUTY CHARGE - 10/01/2018
15-Jan-18,0,15-Jan-18,,"14,300.00","111,778.86",TRANSFER BETWEEN CUSTOMERS via GAPS 636516015431591657-1   from ROMA FRUIT OF NATURE LIMITED to MC ALISTER NIGERIA LIMITED REF: 0013888548825435890000000
15-Jan-18,0,15-Jan-18,,"7,400.00","119,178.86","TRANSFER BETWEEN CUSTOMERS MBANKING - From Jenny Benoit ANY Account Transfer from ASSAF,ROY ZIAD to MC ALISTER NIGERIA LIMITED"
15-Jan-18,0,15-Jan-18,100,,"119,078.86",STAMP DUTY CHARGE 15012018 STAMP DUTY CHARGE - 15/01/2018
19-Jan-18,836,19-Jan-18,"70,000.00",,"49,078.86",CHEQUE DEPOSIT CHQ DEP IFO QUADRI OLAWALE FRM MC ALISTER NIGERIA LIMITED
29-Jan-18,485,29-Jan-18,,"21,700.00","70,778.86",CHEQUE DEPOSIT CHQ DEP FRM GRAND SQ. SUPERMKT&STORES LTD TO MC ALISTER NIGERIA LIMITED
29-Jan-18,3028,29-Jan-18,,"49,229.98","120,008.84",CHEQUE DEPOSIT CHQ DEP FRM GRAND SQ. SUPERMKT&STORES LTD TO MC ALISTER NIGERIA LIMITED
29-Jan-18,3099,29-Jan-18,,"26,380.00","146,388.84",CHEQUE DEPOSIT CHQ DEP FRM GRAND SQ. SUPERMKT&STORES LTD TO MC ALISTER NIGERIA LIMITED
29-Jan-18,0,29-Jan-18,150,,"146,238.84",STAMP DUTY CHARGE 29012018 STAMP DUTY CHARGE - 29/01/2018
1-Feb-18,0,31-Jan-18,70,,"146,168.84",ACCOUNT MAINTENANCE CHARGE
1-Feb-18,0,31-Jan-18,3.5,,"146,165.34",VALUE ADDED TAX
6-Feb-18,0,6-Feb-18,,"16,600.00","162,765.34",TRANSFER BETWEEN CUSTOMERS via GAPS 636535047788485758-1   from ROMA FRUIT OF NATURE LIMITED to MC ALISTER NIGERIA LIMITED REF: 0013888548961817600000000
6-Feb-18,0,6-Feb-18,50,,"162,715.34",STAMP DUTY CHARGE 06022018 STAMP DUTY CHARGE - 06/02/2018
11-Feb-18,0,12-Feb-18,,"408,670.00","571,385.34",TRANSFER BETWEEN CUSTOMERS via Internet Banking Paid from Aug 2017 to Dec 2017 from PREMIER CORP. FORTE NIG. LTD to MC ALISTER NIGERIA LIMITED
12-Feb-18,0,12-Feb-18,50,,"571,335.34",STAMP DUTY CHARGE 12022018 STAMP DUTY CHARGE - 12/02/2018
13-Feb-18,0,13-Feb-18,,"17,700.00","589,035.34",TRANSFER BETWEEN CUSTOMERS via GAPS 636541212296666680-1   from ROMA FRUIT OF NATURE LIMITED to MC ALISTER NIGERIA LIMITED REF: 0013888548122029901000000
13-Feb-18,0,13-Feb-18,,"5,600.00","594,635.34",TRANSFER BETWEEN CUSTOMERS USSD GTBank Transfer from : 08027643804 RAHEEM ADEYEMISI to MC ALISTER NIGERIA LIMITED REF: 63654133766263911425873
13-Feb-18,0,13-Feb-18,50,,"594,585.34",STAMP DUTY CHARGE 13022018 STAMP DUTY CHARGE - 13/02/2018
14-Feb-18,732,14-Feb-18,,"350,000.00","944,585.34",CHEQUE DEPOSIT CHQ DEP FRM RHAPSODYS MASTER FRANCH. LTD TO MC ALISTER NIGERIA LIMITED
14-Feb-18,0,14-Feb-18,50,,"944,535.34",STAMP DUTY CHARGE 14022018 STAMP DUTY CHARGE - 14/02/2018
15-Feb-18,780,15-Feb-18,,"527,964.00","1,472,499.34",CHEQUE DEPOSIT CHQ DEP IFO MC ALISTER NIG LTD FRM RHAPSODYS MASTER FRANCH. LTD
15-Feb-18,0,15-Feb-18,50,,"1,472,449.34",STAMP DUTY CHARGE 15022018 STAMP DUTY CHARGE - 15/02/2018
16-Feb-18,837,16-Feb-18,"1,197,345.00",,"275,104.34",CHEQUE DEPOSIT CHQ DEP IFO ASKOL NIG. LTD FRM MC ALISTER NIG. LTD
22-Feb-18,781,22-Feb-18,,"200,000.00","475,104.34",CHEQUE DEPOSIT CHQ DEP FRM RHAPSODYS MASTER FRANCH LTD IFO MC ALISTER NIG LTD
22-Feb-18,9979771,22-Feb-18,,"146,000.00","621,104.34",TRANSFER BETWEEN CUSTOMERS via GAPS 41435083 DTH_PAYABLE_FEB_18 from DOWNTOWN HOTEL & CAT. SERVICES 244 to MC ALISTER NIGERIA LIMITED REF: 0216947983414350830000000
22-Feb-18,0,22-Feb-18,100,,"621,004.34",STAMP DUTY CHARGE 22022018 STAMP DUTY CHARGE - 22/02/2018
28-Feb-18,6572,28-Feb-18,,"2,764,610.00","3,385,614.34",CHEQUE DEPOSIT CHQ DEP IFO MC ALISTER NIG LTD FRM HUBMART STORES LIMITED
28-Feb-18,838,28-Feb-18,"3,000,000.00",,"385,614.34",CHEQUE DEPOSIT CHQ DEP IFO 4BOYZ ENTERPRISES FRM MC ALISTER NIG. LTD
28-Feb-18,0,28-Feb-18,50,,"385,564.34",STAMP DUTY CHARGE 28022018 STAMP DUTY CHARGE - 28/02/2018
1-Mar-18,0,28-Feb-18,"4,197.35",,"381,366.99",ACCOUNT MAINTENANCE CHARGE
1-Mar-18,0,28-Feb-18,209.87,,"381,157.12",VALUE ADDED TAX
1-Mar-18,782,1-Mar-18,,"200,000.00","581,157.12",CHEQUE DEPOSIT CHQ DEP FRM RHAPSODYS MASTER FRANCH. LTD TO MC ALISTER NIGERIA LIMITED
1-Mar-18,0,1-Mar-18,50,,"581,107.12",STAMP DUTY CHARGE 01032018 STAMP DUTY CHARGE - 01/03/2018
2-Mar-18,0,2-Mar-18,,"14,600.00","595,707.12","TRANSFER BETWEEN CUSTOMERS GTWORLD - Transfer between customers-Via GTWorld Lo'meedar Fresh ANY Account Transfer from ADIGUN, AMIDAT IFEDOLAPO to MC ALISTER NIGERIA LIMITED"
2-Mar-18,839,2-Mar-18,"150,000.00",,"445,707.12",CASH WITHDRAWAL PATIENCE UDOH
4-Mar-18,0,5-Mar-18,,"12,800.00","458,507.12",TRANSFER BETWEEN CUSTOMERS via GAPS 636557626581350163-1   from ROMA FRUIT OF NATURE LIMITED to MC ALISTER NIGERIA LIMITED REF: 0013888548121738588000000
5-Mar-18,6653,5-Mar-18,,"1,988,740.00","2,447,247.12",CHEQUE DEPOSIT CHQ DEP IFO MC ALISTER NIG LTD FRM HUBMART STORES LIMITED
5-Mar-18,0,5-Mar-18,100,,"2,447,147.12",STAMP DUTY CHARGE 05032018 STAMP DUTY CHARGE - 05/03/2018
7-Mar-18,840,7-Mar-18,"493,500.00",,"1,953,647.12",CHEQUE DEPOSIT CHQ DEP IFO FATAI ADEROJU BY MC ALISTER NIG LTD
8-Mar-18,841,8-Mar-18,"300,000.00",,"1,653,647.12",NIBSS Instant Payment Outward 000013180308154512000086786801 TRF IFO DBN/MAJED ELRACHIDI REF:000013180308154512000086786801
8-Mar-18,841,8-Mar-18,50,,"1,653,597.12",COMMISSION 000013180308154512000086786801 TRF IFO DBN/MAJED ELRACHIDI REF:000013180308154512000086786801
8-Mar-18,841,8-Mar-18,2.5,,"1,653,594.62",VALUE ADDED TAX TRF IFO DBN/MAJED ELRACHIDI
8-Mar-18,843,8-Mar-18,"750,000.00",,"903,594.62",NIBSS Instant Payment Outward 000013180308154848000086788438 NIPT FRM MC ALISTER NIGERIA LIMITED IFO JAIZ/DUOLYT BIZ MODEL REF:000013180308154848000086788438
8-Mar-18,843,8-Mar-18,50,,"903,544.62",COMMISSION 000013180308154848000086788438 NIPT FRM MC ALISTER NIGERIA LIMITED IFO JAIZ/DUOLYT BIZ MODEL REF:000013180308154848000086788438
8-Mar-18,843,8-Mar-18,2.5,,"903,542.12",VALUE ADDED TAX NIPT FRM MC ALISTER NIGERIA LIMI
8-Mar-18,842,8-Mar-18,"350,000.00",,"553,542.12",NIBSS Instant Payment Outward 000013180308161107000086799756 TRF IFO DBN/MAJED ELRACHIDI REF:000013180308161107000086799756
8-Mar-18,842,8-Mar-18,50,,"553,492.12",COMMISSION 000013180308161107000086799756 TRF IFO DBN/MAJED ELRACHIDI REF:000013180308161107000086799756
8-Mar-18,842,8-Mar-18,2.5,,"553,489.62",VALUE ADDED TAX TRF IFO DBN/MAJED ELRACHIDI
9-Mar-18,844,9-Mar-18,"500,000.00",,"53,489.62",CHEQUE DEPOSIT CHQ DEP IFO ASKOL NIGERIA LTD FRM MC ALISTER NIGERIA LIMITED
15-Mar-18,161,15-Mar-18,,"155,350.00","208,839.62",CHEQUE DEPOSIT CHQ DEP IFO MC ALISTER NIG LTD FRM NOIR RESTAURANT&BAR LTD
15-Mar-18,0,15-Mar-18,50,,"208,789.62",STAMP DUTY CHARGE 15032018 STAMP DUTY CHARGE - 15/03/2018
16-Mar-18,0,16-Mar-18,,"10,350.00","219,139.62","TRANSFER BETWEEN CUSTOMERS GTWORLD - Transfer between customers-Via GTWorld Lo'meedar Fresh fruits ANY Account Transfer from ADIGUN, AMIDAT IFEDOLAPO to MC ALISTER NIGERIA LIMITED"
16-Mar-18,845,16-Mar-18,"200,000.00",,"19,139.62",CHEQUE DEPOSIT CHQ DEP FRM MC ALISTER NIGERIA LIMITED TO ASKOL NIGERIA LTD
19-Mar-18,6841,19-Mar-18,,"2,777,060.00","2,796,199.62",CHEQUE DEPOSIT CHQ DEP IFO MC ALISTER NIG. LTD FRM HUBMART STORES LTD
19-Mar-18,0,19-Mar-18,50,,"2,796,149.62",STAMP DUTY CHARGE 19032018 STAMP DUTY CHARGE - 19/03/2018
20-Mar-18,846,20-Mar-18,"2,700,000.00",,"96,149.62",CHEQUE DEPOSIT CHQ DEP IFO 4BOYS ENTERPRISES FRM MC ALISTER NIG LTD
22-Mar-18,920,22-Mar-18,,"558,110.00","654,259.62",CHEQUE DEPOSIT CHQ DEP IFO MC ALISTER NIG LTD FRM PREMIER CORP.FORTE NIG.LTD
22-Mar-18,847,22-Mar-18,"80,000.00",,"574,259.62",CLEARING WITHDRAWAL ECO//CHQ//210318 WASTE POINT LTD Ref:GTC121477333411000000847000000
22-Mar-18,848,22-Mar-18,"500,000.00",,"74,259.62",CHEQUE DEPOSIT CHQ DEP FRM MC ALISTER NIGERIA LIMITED TO 4BOYZ ENTERPRISE
22-Mar-18,0,22-Mar-18,50,,"74,209.62",STAMP DUTY CHARGE 22032018 STAMP DUTY CHARGE - 22/03/2018
28-Mar-18,6936,28-Mar-18,,"1,692,830.00","1,767,039.62",CHEQUE DEPOSIT CHQ DEP IFO MC ALISTER NIG LTD FRM HUBMART STORES LTD
28-Mar-18,0,28-Mar-18,50,,"1,766,989.62",STAMP DUTY CHARGE 28032018 STAMP DUTY CHARGE - 28/03/2018
29-Mar-18,849,29-Mar-18,"1,369,730.00",,"397,259.62",CHEQUE DEPOSIT CHQ DEP FRM MC ALISTER NIGERIA LIMITED TO ASKOL NIGERIA LTD
29-Mar-18,850,29-Mar-18,"150,000.00",,"247,259.62",CASH WITHDRAWAL UDOH PATIENCE
29-Mar-18,929,29-Mar-18,,"545,470.00","792,729.62",CHEQUE DEPOSIT CHQ DEP IFO MC ALISTER NIG LTD FRM PREMIER CORP.FORTE NIG.LTD
29-Mar-18,0,29-Mar-18,50,,"792,679.62",STAMP DUTY CHARGE 29032018 STAMP DUTY CHARGE - 29/03/2018
30-Mar-18,0,29-Mar-18,"7,543.23",,"785,136.39",ACCOUNT MAINTENANCE CHARGE
30-Mar-18,0,29-Mar-18,377.16,,"784,759.23",VALUE ADDED TAX
3-Apr-18,851,3-Apr-18,"150,000.00",,"634,759.23",CASH WITHDRAWAL PATIENCE UDOH
3-Apr-18,852,3-Apr-18,"25,000.00",,"609,759.23",CHEQUE DEPOSIT CHEQ DEP IFO QUADRI OLAWALE FRM MC ALISTER NIGERIA LIMITED
3-Apr-18,6937,3-Apr-18,,"1,217,900.00","1,827,659.23",CHEQUE DEPOSIT CHQ DEP IFO MC ALISTER NIGERIA LIMITED FRM HUBMART STORES LIMITED
3-Apr-18,0,3-Apr-18,50,,"1,827,609.23",STAMP DUTY CHARGE 03042018 STAMP DUTY CHARGE - 03/04/2018
4-Apr-18,854,4-Apr-18,"150,000.00",,"1,677,609.23",CASH WITHDRAWAL UDOH PATIENCE
4-Apr-18,853,4-Apr-18,"241,500.00",,"1,436,109.23",NIBSS Instant Payment Outward 000013180404150747000097602794 NIPT FRM MC ALISTER NIGERIA LIMITED IFO DBN/AL MUSHINA DISTRIBUTION COMPANY NIG LTD REF:000013180404150747000097602794
4-Apr-18,853,4-Apr-18,50,,"1,436,059.23",COMMISSION 000013180404150747000097602794 NIPT FRM MC ALISTER NIGERIA LIMITED IFO DBN/AL MUSHINA DISTRIBUTION COMPANY NIG LTD REF:000013180404150747000097602794
4-Apr-18,853,4-Apr-18,2.5,,"1,436,056.73",VALUE ADDED TAX NIPT FRM MC ALISTER NIGERIA LIMI
6-Apr-18,7334,6-Apr-18,,"1,421,130.00","2,857,186.73",CHEQUE DEPOSIT CHQ DEP IFO MC ALISTER NIGERIA LTD FRM HUBMART STORES LIMITED
6-Apr-18,855,6-Apr-18,"697,115.00",,"2,160,071.73",CHEQUE DEPOSIT CHQ IFO ASKOL NIG LTD FRM MC ALISTER NIGERIA LTD
6-Apr-18,0,6-Apr-18,50,,"2,160,021.73",STAMP DUTY CHARGE 06042018 STAMP DUTY CHARGE - 06/04/2018
8-Apr-18,0,9-Apr-18,,"28,350.00","2,188,371.73",TRANSFER BETWEEN CUSTOMERS via GAPS 636587953551168606-1 43544957 from ROMA FRUIT OF NATURE LIMITED to MC ALISTER NIGERIA LIMITED REF: 0013888548435449570000000
8-Apr-18,0,9-Apr-18,,"28,350.00","2,216,721.73",TRANSFER BETWEEN CUSTOMERS via GAPS 636587954348957462-2 43544958 from ROMA FRUIT OF NATURE LIMITED to MC ALISTER NIGERIA LIMITED REF: 0013888548435449580000000
9-Apr-18,0,9-Apr-18,180,,"2,216,541.73",ONLINE STATEMENT CHARGE charge for 9 Pages Statement ifo MC ALISTER NIGERIA LIMITED/ 214/773334/1/1/0
9-Apr-18,0,9-Apr-18,9,,"2,216,532.73",VALUE ADDED TAX MC ALISTER NIGERIA LIMITED / 214/
9-Apr-18,0,9-Apr-18,100,,"2,216,432.73",STAMP DUTY CHARGE 09042018 STAMP DUTY CHARGE - 09/04/2018
10-Apr-18,856,10-Apr-18,"2,100,000.00",,"116,432.73",CHEQUE DEPOSIT CHQ DEP FRM MC ALISTER NIGERIA LIMITED TO 4BOYZ ENTERPRISE
11-Apr-18,0,11-Apr-18,,"200,000.00","316,432.73",TRANSFER BETWEEN CUSTOMERS 000014180411144000246505632834|PL_Replacement of cheq for MC ALISTER_samas|0005008467|ACCESS|Rhapsodys Master Franchise Limited REF:000014180411144000246505632834
11-Apr-18,0,11-Apr-18,50,,"316,382.73",STAMP DUTY CHARGE 11042018 STAMP DUTY CHARGE - 11/04/2018
18-Apr-18,7132,18-Apr-18,,"1,332,820.00","1,649,202.73",CHEQUE DEPOSIT CHQ DEP FRM HUBMART STORES LIMITED TO MC ALISTER NIGERIA LIMITED
18-Apr-18,0,18-Apr-18,50,,"1,649,152.73",STAMP DUTY CHARGE 18042018 STAMP DUTY CHARGE - 18/04/2018
20-Apr-18,0,20-Apr-18,,"3,150.00","1,652,302.73","TRANSFER BETWEEN CUSTOMERS GTWORLD - Transfer between customers-Via GTWorld Lo'meedar Fresh kiwi ANY Account Transfer from ADIGUN, AMIDAT IFEDOLAPO to MC ALISTER NIGERIA LIMITED"
20-Apr-18,858,20-Apr-18,"1,500,000.00",,"152,302.73",CHEQUE DEPOSIT CHQ DEP FRM MC ALISTER NIG LTD IFO ASKOL NIGERIA LTD
25-Apr-18,0,25-Apr-18,180,,"152,122.73",ONLINE STATEMENT CHARGE charge for 9 Pages Statement ifo MC ALISTER NIGERIA LIMITED/ 214/773334/1/1/0
25-Apr-18,0,25-Apr-18,9,,"152,113.73",VALUE ADDED TAX MC ALISTER NIGERIA LIMITED / 214/
25-Apr-18,19,25-Apr-18,,"160,740.50","312,854.23",CHEQUE DEPOSIT CHQ DEP FRM THE AVENUE SUITES TO MC ALISTER NIGERIA LIMITED
25-Apr-18,0,25-Apr-18,50,,"312,804.23",STAMP DUTY CHARGE 25042018 STAMP DUTY CHARGE - 25/04/2018
26-Apr-18,7207,26-Apr-18,,"1,480,000.00","1,792,804.23",CHEQUE DEPOSIT CHQ DEP FRM HUBMART STORES LIMITED TO MC ALISTER NIGERIA LIMITED
26-Apr-18,0,26-Apr-18,50,,"1,792,754.23",STAMP DUTY CHARGE 26042018 STAMP DUTY CHARGE - 26/04/2018
27-Apr-18,859,27-Apr-18,"1,700,000.00",,"92,754.23",CHEQUE DEPOSIT CHQ DEP FRM MC ALISTER NIGERIA LIMITED TO 4BOYZ ENTERPRISE
30-Apr-18,263,30-Apr-18,,"484,210.00","576,964.23",CHEQUE DEPOSIT CHQ DEP FRM GOODISS SUPERSTORES LTD TO MC ALISTER NIGERIA LIMITED
30-Apr-18,0,30-Apr-18,,"1,950.00","578,914.23",TRANSFER BETWEEN CUSTOMERS via GAPS 636606931452831822-1   from ROMA FRUIT OF NATURE LIMITED to MC ALISTER NIGERIA LIMITED REF: 0013888548135225930000000
30-Apr-18,0,30-Apr-18,100,,"578,814.23",STAMP DUTY CHARGE 30042018 STAMP DUTY CHARGE - 30/04/2018
1-May-18,0,30-Apr-18,"6,563.62",,"572,250.61",ACCOUNT MAINTENANCE CHARGE
1-May-18,0,30-Apr-18,328.18,,"571,922.43",VALUE ADDED TAX
3-May-18,877,3-May-18,,"200,000.00","771,922.43",CHEQUE DEPOSIT CHQ DEP FRM RHAPSODYS MASTER FRANCH.LTD IFO MC ALISTER NIG LTD
3-May-18,7309,3-May-18,,"1,468,280.00","2,240,202.43",CHEQUE DEPOSIT CHQ DEP FRM HUBMART STORES LTD IFO MC ALISTER NIG LTD
3-May-18,0,3-May-18,100,,"2,240,102.43",STAMP DUTY CHARGE 03052018 STAMP DUTY CHARGE - 03/05/2018
4-May-18,860,4-May-18,"1,719,365.00",,"520,737.43",CHEQUE DEPOSIT CHQ DEP IFO ASKOL NIGERIA LTD FRM MC ALISTER NIGERIA LIMITED
7-May-18,0,7-May-18,,"11,900.00","532,637.43",TRANSFER BETWEEN CUSTOMERS via GAPS 636613043103072068-1   from ROMA FRUIT OF NATURE LIMITED to MC ALISTER NIGERIA LIMITED REF: 0013888548153830401000000
7-May-18,0,7-May-18,50,,"532,587.43",STAMP DUTY CHARGE 07052018 STAMP DUTY CHARGE - 07/05/2018
8-May-18,262,8-May-18,,"400,000.00","932,587.43",CHEQUE DEPOSIT CHQ DEP FRM GOODISS SUPERSTORES LTD TO MC ALISTER NIGERIA LIMITED
8-May-18,861,8-May-18,"800,000.00",,"132,587.43",CHEQUE DEPOSIT CHQ DEP FRM MC ALISTER NIGERIA LIMITED TO 4BOYZ ENTERPRISE
8-May-18,0,8-May-18,50,,"132,537.43",STAMP DUTY CHARGE 08052018 STAMP DUTY CHARGE - 08/05/2018
9-May-18,7502,9-May-18,,"1,722,620.00","1,855,157.43",CHEQUE DEPOSIT CHQ DEP IFO MC ALISTER NIG LTD FRM HUBMART STORES LIMITED
9-May-18,21549557,9-May-18,,"5,000.00","1,860,157.43",CASH DEPOSIT john o. odulami
9-May-18,0,9-May-18,100,,"1,860,057.43",STAMP DUTY CHARGE 09052018 STAMP DUTY CHARGE - 09/05/2018
14-May-18,980,14-May-18,,"839,760.00","2,699,817.43",CHEQUE DEPOSIT CHQ DEP IFO MC ALISTER NIGERIA LIMITED FRM PREMIER CORP. FORTE NIG. LTD
14-May-18,0,14-May-18,50,,"2,699,767.43",STAMP DUTY CHARGE 14052018 STAMP DUTY CHARGE - 14/05/2018
15-May-18,862,15-May-18,"2,500,000.00",,"199,767.43",CHEQUE DEPOSIT CHQ DEP IFO 4BOYZ ENTERPRISE FRM MC ALISTER NIGERIA LIMITED
17-May-18,7581,17-May-18,,"1,743,860.00","1,943,627.43",CHEQUE DEPOSIT CHQ DEP IFO MC ALISTER NIGERIA LIMITED FRM HUBMART STORES LIMITED
17-May-18,0,17-May-18,50,,"1,943,577.43",STAMP DUTY CHARGE 17052018 STAMP DUTY CHARGE - 17/05/2018
21-May-18,0,21-May-18,,"14,650.00","1,958,227.43","TRANSFER BETWEEN CUSTOMERS GTWORLD - Transfer between customers-Via GTWorld Friits for Lo'meedar Fresh fruit basket ANY Account Transfer from ADIGUN, AMIDAT IFEDOLAPO to MC ALISTER NIGERIA LIMITED"
21-May-18,939,21-May-18,,"123,000.00","2,081,227.43",CHEQUE DEPOSIT CHQ DEP FRM RHAPSODYS MASTER FRANCH. LTD TO MC ALISTER NIGERIA LIMITED
21-May-18,0,21-May-18,50,,"2,081,177.43",STAMP DUTY CHARGE 21052018 STAMP DUTY CHARGE - 21/05/2018
22-May-18,863,22-May-18,"2,000,000.00",,"81,177.43",CHEQUE DEPOSIT CHQ DEP FRM MC ALISTER NIGERIA LIMITED TO 4BOYZ ENTERPRISE
24-May-18,864,24-May-18,"37,500.00",,"43,677.43",CASH WITHDRAWAL SHOBANKE ABIODUN
25-May-18,7706,25-May-18,,"1,624,610.00","1,668,287.43",CHEQUE DEPOSIT CHQ DEP FRM HUBMART STORES LIMITED TO MC ALISTER NIGERIA LIMITED
25-May-18,865,25-May-18,"1,476,045.00",,"192,242.43",CHEQUE DEPOSIT CHQ DEP FRM MC ALISTER NIGERIA LIMITED TO ASKOL NIGERIA LTD
25-May-18,0,25-May-18,50,,"192,192.43",STAMP DUTY CHARGE 25052018 STAMP DUTY CHARGE - 25/05/2018
28-May-18,426,28-May-18,,"494,795.00","686,987.43",CHEQUE DEPOSIT CHQ DEP IFO MC ALISTER NIGERIA LTD FRM GOODISS SUPERSTORES LTD
28-May-18,0,28-May-18,"4,894.04",,"682,093.39",COMMISSION FOR SWIFT TRANSFER GTB633687C/18/FTFX:633687FX TRF : MC ALISTER NIGERIA LIMITED/ILAN TOT PLC
28-May-18,0,28-May-18,244.7,,"681,848.69",VAT ON COMM FOR SWIFT TRANSFER GTB633687C/18/FTFX:633687FX TRF : MC ALISTER NIGERIA LIMITED/ILAN TOT PLC
28-May-18,0,28-May-18,"6,000.00",,"675,848.69",SWIFT/TELEX CHARGE GTB633687C/18/FTFX:633687FX TRF : MC ALISTER NIGERIA LIMITED/ILAN TOT PLC
28-May-18,0,28-May-18,"8,438.00",,"667,410.69",OVERSEAS BANK CHARGES GTB633687C/18/FTFX:633687FX TRF : MC ALISTER NIGERIA LIMITED/ILAN TOT PLC
28-May-18,866,28-May-18,"150,000.00",,"517,410.69",CASH WITHDRAWAL PATIENCE UDOH
28-May-18,0,28-May-18,50,,"517,360.69",STAMP DUTY CHARGE 28052018 STAMP DUTY CHARGE - 28/05/2018
30-May-18,867,30-May-18,"450,000.00",,"67,360.69",CHEQUE DEPOSIT CHQ DEP FRM MC ALISTER NIGERIA LIMITED TO 4BOYZ ENTERPRISE
1-Jun-18,0,31-May-18,"9,132.91",,"58,227.78",ACCOUNT MAINTENANCE CHARGE
1-Jun-18,0,31-May-18,456.65,,"57,771.13",VALUE ADDED TAX
1-Jun-18,32,1-Jun-18,,"188,000.00","245,771.13",CHEQUE DEPOSIT CHQ DEP FRM MALLMART YABA TO MC ALISTER NIGERIA LIMITED
1-Jun-18,0,1-Jun-18,50,,"245,721.13",STAMP DUTY CHARGE 01062018 STAMP DUTY CHARGE - 01/06/2018
2-Jun-18,0,4-Jun-18,,"203,340.00","449,061.13",TRANSFER BETWEEN CUSTOMERS via GAPS 636635509755201494-1   from ROMA FRUIT OF NATURE LIMITED to MC ALISTER NIGERIA LIMITED REF: 0013888548154255347000000
4-Jun-18,7804,4-Jun-18,,"1,698,420.00","2,147,481.13",CHEQUE DEPOSIT CHQ DEP FRM HUBMART STORES LIMITED TO MC ALISTER NIGERIA LIMITED
4-Jun-18,868,4-Jun-18,"322,000.00",,"1,825,481.13",CHEQUE DEPOSIT CHQ DEP FRM MC ALISTER NIGERIA LIMITED TO FACSM INTEGRATED SERV.NIG.LTD
4-Jun-18,869,4-Jun-18,"1,700,000.00",,"125,481.13",CHEQUE DEPOSIT CHQ DEP IFO 4BOYZ ENTERPRISE FRM MC ALISTER NIGERIA LIMITED
4-Jun-18,0,4-Jun-18,100,,"125,381.13",STAMP DUTY CHARGE 04062018 STAMP DUTY CHARGE - 04/06/2018
6-Jun-18,7986,6-Jun-18,,"2,244,180.00","2,369,561.13",CHEQUE DEPOSIT CHEQ DEPOSIT IFO MC ALISTER NIGERIA LIMITED FRM HUBMART STORES LIMITED
6-Jun-18,870,6-Jun-18,"2,300,000.00",,"69,561.13",CHEQUE DEPOSIT CHEQ DEPOSIT IFO 4BOYZ ENTERPRISE FRM MC ALISTER NIGERIA LIMITED
6-Jun-18,0,6-Jun-18,50,,"69,511.13",STAMP DUTY CHARGE 06062018 STAMP DUTY CHARGE - 06/06/2018
7-Jun-18,0,7-Jun-18,,"55,600.00","125,111.13",TRANSFER BETWEEN CUSTOMERS USSD GTBank Transfer from : 08034392372 ONADEKO ADERONKE to MC ALISTER NIGERIA LIMITED REF: 63663970763671657736729
7-Jun-18,0,7-Jun-18,"9,741.22",,"115,369.91",COMMISSION FOR SWIFT TRANSFER GTB640045C/18/FTFX:640045FX TRF : MC ALISTER NIGERIA LIMITED/JITTU HORTICULTURE PLC
7-Jun-18,0,7-Jun-18,487.06,,"114,882.85",VAT ON COMM FOR SWIFT TRANSFER GTB640045C/18/FTFX:640045FX TRF : MC ALISTER NIGERIA LIMITED/JITTU HORTICULTURE PLC
7-Jun-18,0,7-Jun-18,"6,000.00",,"108,882.85",SWIFT/TELEX CHARGE GTB640045C/18/FTFX:640045FX TRF : MC ALISTER NIGERIA LIMITED/JITTU HORTICULTURE PLC
7-Jun-18,0,7-Jun-18,"8,478.00",,"100,404.85",OVERSEAS BANK CHARGES GTB640045C/18/FTFX:640045FX TRF : MC ALISTER NIGERIA LIMITED/JITTU HORTICULTURE PLC
7-Jun-18,0,7-Jun-18,50,,"100,354.85",STAMP DUTY CHARGE 07062018 STAMP DUTY CHARGE - 07/06/2018
11-Jun-18,0,11-Jun-18,,"211,690.00","312,044.85",TRANSFER BETWEEN CUSTOMERS via GAPS 636643326530111066-1   from ROMA FRUIT OF NATURE LIMITED to MC ALISTER NIGERIA LIMITED REF: 0013888548165053655000000
11-Jun-18,0,11-Jun-18,50,,"311,994.85",STAMP DUTY CHARGE 11062018 STAMP DUTY CHARGE - 11/06/2018
13-Jun-18,871,13-Jun-18,"33,000.00",,"278,994.85",CASH WITHDRAWAL ADENRELE OLAWUNMI MARGARET
13-Jun-18,999,13-Jun-18,,"188,920.00","467,914.85",CHEQUE DEPOSIT CHQ DEP FRM ZEN GARDEN CHINESE REST LTD TO MC ALISTER NIGERIA LIMITED REF:202026138800001889201806131226
13-Jun-18,0,13-Jun-18,50,,"467,864.85",STAMP DUTY CHARGE 13062018 STAMP DUTY CHARGE - 13/06/2018
14-Jun-18,8041,14-Jun-18,,"2,305,970.00","2,773,834.85",CHEQUE DEPOSIT CHQ DEP FRM HUBMART STORES LIMITED TO MC ALISTER NIGERIA LIMITED REF:209076906400023059701806141235
14-Jun-18,2156,21-Jun-18,,"250,506.00","3,024,340.85","CLEARING DEPOSIT, DR A/C IN LOCAL BRANCH PARIS DELI COMPANY LIMITED"
14-Jun-18,41,14-Jun-18,,"146,000.50","3,170,341.35",CHEQUE DEPOSIT CHQ DEP IFO MC ALISTER NIGERIA LIMITED FRM THE AVENUE SUITES REF:201016042000014600051806141518
14-Jun-18,873,14-Jun-18,"500,000.00",,"2,670,341.35",CHEQUE DEPOSIT CHQ DEP IFO 4BOYZ ENTERPRISE FRM MC ALISTER NIGERIA LIMITED REF:214077333400005000001806141519
14-Jun-18,872,14-Jun-18,"2,000,000.00",,"670,341.35",CHEQUE DEPOSIT CHQ DEP IFO ASKOL NIGERIA LTD FRM MC ALISTER NIGERIA LIMITED REF:214077333400020000001806141528
15-Jun-18,0,14-Jun-18,150,,"670,191.35",STAMP DUTY CHARGE 14062018 STAMP DUTY CHARGE - 14/06/2018
19-Jun-18,874,19-Jun-18,"320,000.00",,"350,191.35",CHEQUE DEPOSIT CHQ DEP IFO 4BOYZ ENTERPRISE FRM MC ALISTER NIGERIA LIMITED REF:214077333400003200001806191512
20-Jun-18,875,20-Jun-18,"300,000.00",,"50,191.35",CHEQUE DEPOSIT CHQ DEP IFO 4BOYZ ENTERPRISE FRM MC ALISTER NIGERIA LIMITED REF:214077333400003000001806201254
21-Jun-18,8101,21-Jun-18,,"2,040,290.00","2,090,481.35",CHEQUE DEPOSIT CHQ DEP FRM HUBMART STORES LIMITED TO MC ALISTER NIGERIA LIMITED REF:209076906400020402901806211620
21-Jun-18,993,21-Jun-18,,"866,210.00","2,956,691.35",CHEQUE DEPOSIT CHQ DEP FRM PREMIER CORP. FORTE NIG. LTD TO MC ALISTER NIGERIA LIMITED REF:209074241600008662101806211738
21-Jun-18,0,21-Jun-18,100,,"2,956,591.35",STAMP DUTY CHARGE 21062018 STAMP DUTY CHARGE - 21/06/2018
22-Jun-18,876,22-Jun-18,"2,458,203.00",,"498,388.35",CHEQUE DEPOSIT CHQ DEP FRM MC ALISTER NIGERIA LIMITED TO ASKOL NIGERIA LTD REF:214077333400024582031806221529
25-Jun-18,0,25-Jun-18,,"14,350.00","512,738.35",TRANSFER BETWEEN CUSTOMERS via GAPS 636655004640717982-2   from ROMA FRUIT OF NATURE LIMITED to MC ALISTER NIGERIA LIMITED REF: 0013888548514243160000000
25-Jun-18,0,25-Jun-18,"7,821.80",,"504,916.55",COMMISSION FOR SWIFT TRANSFER GTB649108C/18/FTFX:649108FX TRF : MC ALISTER NIGERIA LIMITED/AUTOMATIC BREWERS SARL
25-Jun-18,0,25-Jun-18,391.09,,"504,525.46",VAT ON COMM FOR SWIFT TRANSFER GTB649108C/18/FTFX:649108FX TRF : MC ALISTER NIGERIA LIMITED/AUTOMATIC BREWERS SARL
25-Jun-18,0,25-Jun-18,"6,000.00",,"498,525.46",SWIFT/TELEX CHARGE GTB649108C/18/FTFX:649108FX TRF : MC ALISTER NIGERIA LIMITED/AUTOMATIC BREWERS SARL
25-Jun-18,0,25-Jun-18,"8,478.00",,"490,047.46",OVERSEAS BANK CHARGES GTB649108C/18/FTFX:649108FX TRF : MC ALISTER NIGERIA LIMITED/AUTOMATIC BREWERS SARL
25-Jun-18,0,25-Jun-18,"8,064.27",,"481,983.19",COMMISSION FOR SWIFT TRANSFER GTB649382C/18/FTFX:649382FX TRF : MC ALISTER NIGERIA LIMITED/VALSTAR HOLLAND BV
25-Jun-18,0,25-Jun-18,403.21,,"481,579.98",VAT ON COMM FOR SWIFT TRANSFER GTB649382C/18/FTFX:649382FX TRF : MC ALISTER NIGERIA LIMITED/VALSTAR HOLLAND BV
25-Jun-18,0,25-Jun-18,"6,000.00",,"475,579.98",SWIFT/TELEX CHARGE GTB649382C/18/FTFX:649382FX TRF : MC ALISTER NIGERIA LIMITED/VALSTAR HOLLAND BV
25-Jun-18,0,25-Jun-18,"8,478.00",,"467,101.98",OVERSEAS BANK CHARGES GTB649382C/18/FTFX:649382FX TRF : MC ALISTER NIGERIA LIMITED/VALSTAR HOLLAND BV
25-Jun-18,0,25-Jun-18,50,,"467,051.98",STAMP DUTY CHARGE 25062018 STAMP DUTY CHARGE - 25/06/2018
26-Jun-18,877,26-Jun-18,"310,000.00",,"157,051.98",CHEQUE DEPOSIT CHQ DEP IFO 4BOYZ ENTERPRISE FRM MC ALISTER NIGERIA LIMITED REF:214077333400003100001806261436
26-Jun-18,0,26-Jun-18,"15,708.04",,"141,343.94",COMMISSION FOR SWIFT TRANSFER GTB650003C/18/FTFX:650003FX TRF : MC ALISTER NIGERIA LIMITED/JITTU HORTICULTURE PLC
26-Jun-18,0,26-Jun-18,785.4,,"140,558.54",VAT ON COMM FOR SWIFT TRANSFER GTB650003C/18/FTFX:650003FX TRF : MC ALISTER NIGERIA LIMITED/JITTU HORTICULTURE PLC
26-Jun-18,0,26-Jun-18,"6,000.00",,"134,558.54",SWIFT/TELEX CHARGE GTB650003C/18/FTFX:650003FX TRF : MC ALISTER NIGERIA LIMITED/JITTU HORTICULTURE PLC
26-Jun-18,0,26-Jun-18,"8,478.00",,"126,080.54",OVERSEAS BANK CHARGES GTB650003C/18/FTFX:650003FX TRF : MC ALISTER NIGERIA LIMITED/JITTU HORTICULTURE PLC
28-Jun-18,0,28-Jun-18,"10,377.81",,"115,702.73",COMMISSION FOR SWIFT TRANSFER GTB651737C/18/FTFX:651737FX TRF : MC ALISTER NIGERIA LIMITED/INTERNATIONAL FRESH PRODUCE
28-Jun-18,0,28-Jun-18,518.89,,"115,183.84",VAT ON COMM FOR SWIFT TRANSFER GTB651737C/18/FTFX:651737FX TRF : MC ALISTER NIGERIA LIMITED/INTERNATIONAL FRESH PRODUCE
28-Jun-18,0,28-Jun-18,"6,000.00",,"109,183.84",SWIFT/TELEX CHARGE GTB651737C/18/FTFX:651737FX TRF : MC ALISTER NIGERIA LIMITED/INTERNATIONAL FRESH PRODUCE
28-Jun-18,0,28-Jun-18,"8,593.75",,"100,590.09",OVERSEAS BANK CHARGES GTB651737C/18/FTFX:651737FX TRF : MC ALISTER NIGERIA LIMITED/INTERNATIONAL FRESH PRODUCE
30-Jun-18,0,29-Jun-18,"10,243.20",,"90,346.89",ACCOUNT MAINTENANCE CHARGE
30-Jun-18,0,29-Jun-18,512.16,,"89,834.73",VALUE ADDED TAX
2-Jul-18,8189,2-Jul-18,,"2,405,480.00","2,495,314.73",CHEQUE DEPOSIT CHQ DEP FRM HUBMART STORES LTD TO MC ALISTER NIG LTD
2-Jul-18,0,2-Jul-18,50,,"2,495,264.73",STAMP DUTY CHARGE 02072018 STAMP DUTY CHARGE - 02/07/2018
3-Jul-18,878,3-Jul-18,"2,174,320.00",,"320,944.73",CHEQUE DEPOSIT CHQ DEP IFO ASKOL NIGERIA LTD FRM MC ALISTER NIGERIA LIMITED REF:214077333400021743201807031619
5-Jul-18,8293,5-Jul-18,,"1,261,840.00","1,582,784.73",CHEQUE DEPOSIT CHQ DEP IFO MC ALISTER NIG LTD FRM HUBMART STORES LIMITED REF:209076906400012618401807051718
5-Jul-18,0,5-Jul-18,50,,"1,582,734.73",STAMP DUTY CHARGE 05072018 STAMP DUTY CHARGE - 05/07/2018
6-Jul-18,879,6-Jul-18,"1,452,455.00",,"130,279.73",CHEQUE DEPOSIT CHQ DEP IFO ASKOL NIGERIA LTD FRM MC ALISTER NIGERIA LIMITED REF:214077333400014524551807061544
9-Jul-18,0,9-Jul-18,"17,247.00",,"113,032.73",COMMISSION FOR SWIFT TRANSFER GTB657510C/18/FTFX:657510FX TRF : MC ALISTER NIGERIA LIMITED/VALSTAR HOLLAND BV
9-Jul-18,0,9-Jul-18,862.35,,"112,170.38",VAT ON COMM FOR SWIFT TRANSFER GTB657510C/18/FTFX:657510FX TRF : MC ALISTER NIGERIA LIMITED/VALSTAR HOLLAND BV
9-Jul-18,0,9-Jul-18,"6,000.00",,"106,170.38",SWIFT/TELEX CHARGE GTB657510C/18/FTFX:657510FX TRF : MC ALISTER NIGERIA LIMITED/VALSTAR HOLLAND BV
9-Jul-18,0,9-Jul-18,"8,623.50",,"97,546.88",OVERSEAS BANK CHARGES GTB657510C/18/FTFX:657510FX TRF : MC ALISTER NIGERIA LIMITED/VALSTAR HOLLAND BV
10-Jul-18,1015,10-Jul-18,,"1,271,895.00","1,369,441.88",CHEQUE DEPOSIT CHQ DEP FRM MC ALISTER NIGERIA LIMITED FRM PREMIER CORP. FORTE NIG. LTD REF:209074241600012718951807100949
10-Jul-18,0,10-Jul-18,50,,"1,369,391.88",STAMP DUTY CHARGE 10072018 STAMP DUTY CHARGE - 10/07/2018
11-Jul-18,880,11-Jul-18,"500,000.00",,"869,391.88",CHEQUE DEPOSIT CHQ DEP FRM MC ALISTER NIGERIA LIMITED TO 4BOYZ ENTERPRISE REF:214077333400005000001807111151
12-Jul-18,8347,12-Jul-18,,"1,313,320.00","2,182,711.88",CHEQUE DEPOSIT CHQ DEP IFO MC ALISTER NIG LTD FRM HUBMART STORES LIMITED REF:209076906400013133201807121653
12-Jul-18,0,12-Jul-18,50,,"2,182,661.88",STAMP DUTY CHARGE 12072018 STAMP DUTY CHARGE - 12/07/2018
13-Jul-18,881,13-Jul-18,"1,993,735.00",,"188,926.88",CHEQUE DEPOSIT CHQ DEP FRM MC ALISTER NIGERIA LIMITED TO ASKOL NIGERIA LTD REF:214077333400019937351807131438
16-Jul-18,882,16-Jul-18,"150,000.00",,"38,926.88",CASH WITHDRAWAL UDOH PATIENCE
18-Jul-18,8140,18-Jul-18,,"333,000.00","371,926.88",CHEQUE DEPOSIT CHQ DEP IFO MC ALISTER NIGERIA LTD FRM DELIS SUPERMARKET &COFFEE SHOP REF:002010149773333000180718093409
18-Jul-18,0,18-Jul-18,"17,247.00",,"354,679.88",COMMISSION FOR SWIFT TRANSFER GTB662838C/18/FTFX:662838FX TRF : MC ALISTER NIGERIA LIMITED/VALSTAR HOLLAND BV
18-Jul-18,0,18-Jul-18,862.35,,"353,817.53",VAT ON COMM FOR SWIFT TRANSFER GTB662838C/18/FTFX:662838FX TRF : MC ALISTER NIGERIA LIMITED/VALSTAR HOLLAND BV
18-Jul-18,0,18-Jul-18,"6,000.00",,"347,817.53",SWIFT/TELEX CHARGE GTB662838C/18/FTFX:662838FX TRF : MC ALISTER NIGERIA LIMITED/VALSTAR HOLLAND BV
18-Jul-18,0,18-Jul-18,"8,623.50",,"339,194.03",OVERSEAS BANK CHARGES GTB662838C/18/FTFX:662838FX TRF : MC ALISTER NIGERIA LIMITED/VALSTAR HOLLAND BV
18-Jul-18,0,18-Jul-18,50,,"339,144.03",STAMP DUTY CHARGE 18072018 STAMP DUTY CHARGE - 18/07/2018
19-Jul-18,0,19-Jul-18,"8,623.50",,"330,520.53",COMMISSION FOR SWIFT TRANSFER GTB663634C/18/FTFX:663634FX TRF : MC ALISTER NIGERIA LIMITED/SHAHIN ESTABLISHMENT FOR IMPORT AND EXPORT
19-Jul-18,0,19-Jul-18,431.18,,"330,089.35",VAT ON COMM FOR SWIFT TRANSFER GTB663634C/18/FTFX:663634FX TRF : MC ALISTER NIGERIA LIMITED/SHAHIN ESTABLISHMENT FOR IMPORT AND EXPORT
19-Jul-18,0,19-Jul-18,"6,000.00",,"324,089.35",SWIFT/TELEX CHARGE GTB663634C/18/FTFX:663634FX TRF : MC ALISTER NIGERIA LIMITED/SHAHIN ESTABLISHMENT FOR IMPORT AND EXPORT
19-Jul-18,0,19-Jul-18,"8,623.50",,"315,465.85",OVERSEAS BANK CHARGES GTB663634C/18/FTFX:663634FX TRF : MC ALISTER NIGERIA LIMITED/SHAHIN ESTABLISHMENT FOR IMPORT AND EXPORT
19-Jul-18,8439,19-Jul-18,,"1,277,960.00","1,593,425.85",CHEQUE DEPOSIT CHQ DEP IFO MC ALISTER NIGERIA LTD FRM HUBMART STORES LIMITED
19-Jul-18,0,19-Jul-18,50,,"1,593,375.85",STAMP DUTY CHARGE 19072018 STAMP DUTY CHARGE - 19/07/2018
20-Jul-18,883,20-Jul-18,"1,500,000.00",,"93,375.85",CHEQUE DEPOSIT FRM MC ALISTER NIG LTD TO ASKOL NIG LTD
20-Jul-18,0,20-Jul-18,,"14,840.00","108,215.85","TRANSFER BETWEEN CUSTOMERS Transfer between customers-Via GTWorld Lo'meedar Fresh REF:441339599000000148401807201556 from ADIGUN, AMIDAT IFEDOLAPO to MC ALISTER NIGERIA LIMITED"
23-Jul-18,0,23-Jul-18,,"145,080.00","253,295.85",TRANSFER BETWEEN CUSTOMERS via GAPS 636679600558588546-1   from ROMA FRUIT OF NATURE LIMITED to MC ALISTER NIGERIA LIMITED REF: 0013888548162735967000000
23-Jul-18,0,23-Jul-18,50,,"253,245.85",STAMP DUTY CHARGE 23072018 STAMP DUTY CHARGE - 23/07/2018
24-Jul-18,0,24-Jul-18,"17,247.00",,"235,998.85",COMMISSION FOR SWIFT TRANSFER GTB665928C/18/FTFX:665928FX TRF : MC ALISTER NIGERIA LIMITED/VALSTAR HOLLAND BV
24-Jul-18,0,24-Jul-18,862.35,,"235,136.50",VAT ON COMM FOR SWIFT TRANSFER GTB665928C/18/FTFX:665928FX TRF : MC ALISTER NIGERIA LIMITED/VALSTAR HOLLAND BV
24-Jul-18,0,24-Jul-18,"6,000.00",,"229,136.50",SWIFT/TELEX CHARGE GTB665928C/18/FTFX:665928FX TRF : MC ALISTER NIGERIA LIMITED/VALSTAR HOLLAND BV
24-Jul-18,0,24-Jul-18,"8,623.50",,"220,513.00",OVERSEAS BANK CHARGES GTB665928C/18/FTFX:665928FX TRF : MC ALISTER NIGERIA LIMITED/VALSTAR HOLLAND BV
24-Jul-18,0,24-Jul-18,,"10,000.00","230,513.00",TRANSFER BETWEEN CUSTOMERS via GAPS 636680376986849978-1   from ROMA FRUIT OF NATURE LIMITED to MC ALISTER NIGERIA LIMITED REF: 0013888548141388000000000
24-Jul-18,0,24-Jul-18,50,,"230,463.00",STAMP DUTY CHARGE 24072018 STAMP DUTY CHARGE - 24/07/2018
26-Jul-18,8576,26-Jul-18,,"1,218,340.00","1,448,803.00",CHEQUE DEPOSIT CHQ DEP IFO MC ALISTER NIG LTD FRM HUBMART STORES LIMITED REF:209076906400012183401807261722
26-Jul-18,0,26-Jul-18,50,,"1,448,753.00",STAMP DUTY CHARGE 26072018 STAMP DUTY CHARGE - 26/07/2018
31-Jul-18,884,31-Jul-18,"1,300,000.00",,"148,753.00",CHEQUE DEPOSIT CHQ DEP IFO 4BOYZ ENTERPRISE FRM MC ALISTER NIGERIA LIMITED REF:214077333400013000001807311304
31-Jul-18,0,31-Jul-18,"9,070.51",,"139,682.49",ACCOUNT MAINTENANCE CHARGE
31-Jul-18,0,31-Jul-18,453.53,,"139,228.96",VALUE ADDED TAX
1-Aug-18,0,1-Aug-18,"17,347.00",,"121,881.96",COMMISSION FOR SWIFT TRANSFER GTB670872C/18/FTFX:670872FX TRF : MC ALISTER NIGERIA LIMITED/BE-FRESH PRODUCE BV
1-Aug-18,0,1-Aug-18,867.35,,"121,014.61",VAT ON COMM FOR SWIFT TRANSFER GTB670872C/18/FTFX:670872FX TRF : MC ALISTER NIGERIA LIMITED/BE-FRESH PRODUCE BV
1-Aug-18,0,1-Aug-18,"6,000.00",,"115,014.61",SWIFT/TELEX CHARGE GTB670872C/18/FTFX:670872FX TRF : MC ALISTER NIGERIA LIMITED/BE-FRESH PRODUCE BV
1-Aug-18,0,1-Aug-18,"8,673.50",,"106,341.11",OVERSEAS BANK CHARGES GTB670872C/18/FTFX:670872FX TRF : MC ALISTER NIGERIA LIMITED/BE-FRESH PRODUCE BV
1-Aug-18,8648,1-Aug-18,,"1,205,730.00","1,312,071.11",CHEQUE DEPOSIT CHQ DEP IFO MC ALISTER NIGERIA LIMITED FRM HUBMART STORES LIMITED REF:209076906400012057301808011516
1-Aug-18,0,1-Aug-18,50,,"1,312,021.11",STAMP DUTY CHARGE 01082018 STAMP DUTY CHARGE - 01/08/2018
2-Aug-18,885,2-Aug-18,"885,000.00",,"427,021.11",CHEQUE DEPOSIT CHQ DEP FRM MC ALISTER NIGERIA LIMITED TO 4BOYZ ENTERPRISE REF:214077333400008850001808021546
3-Aug-18,0,3-Aug-18,"17,347.00",,"409,674.11",COMMISSION FOR SWIFT TRANSFER GTB672401C/18/FTFX:672401FX TRF : MC ALISTER NIGERIA LIMITED/VALSTAR HOLLAND BV
3-Aug-18,0,3-Aug-18,867.35,,"408,806.76",VAT ON COMM FOR SWIFT TRANSFER GTB672401C/18/FTFX:672401FX TRF : MC ALISTER NIGERIA LIMITED/VALSTAR HOLLAND BV
3-Aug-18,0,3-Aug-18,"6,000.00",,"402,806.76",SWIFT/TELEX CHARGE GTB672401C/18/FTFX:672401FX TRF : MC ALISTER NIGERIA LIMITED/VALSTAR HOLLAND BV
3-Aug-18,0,3-Aug-18,"8,673.50",,"394,133.26",OVERSEAS BANK CHARGES GTB672401C/18/FTFX:672401FX TRF : MC ALISTER NIGERIA LIMITED/VALSTAR HOLLAND BV
7-Aug-18,0,7-Aug-18,,"11,200.00","405,333.26",TRANSFER BETWEEN CUSTOMERS via GAPS 636692365435764565-1   from ROMA FRUIT OF NATURE LIMITED to MC ALISTER NIGERIA LIMITED REF: 0013888548112232480000000
7-Aug-18,0,7-Aug-18,"17,347.00",,"387,986.26",COMMISSION FOR SWIFT TRANSFER GTB674191C/18/FTFX:674191FX TRF : MC ALISTER NIGERIA LIMITED/SHAHIN ESTABLISHMENT FOR IMPORT AND EXPORT
7-Aug-18,0,7-Aug-18,867.35,,"387,118.91",VAT ON COMM FOR SWIFT TRANSFER GTB674191C/18/FTFX:674191FX TRF : MC ALISTER NIGERIA LIMITED/SHAHIN ESTABLISHMENT FOR IMPORT AND EXPORT
7-Aug-18,0,7-Aug-18,"6,000.00",,"381,118.91",SWIFT/TELEX CHARGE GTB674191C/18/FTFX:674191FX TRF : MC ALISTER NIGERIA LIMITED/SHAHIN ESTABLISHMENT FOR IMPORT AND EXPORT
7-Aug-18,0,7-Aug-18,"8,673.50",,"372,445.41",OVERSEAS BANK CHARGES GTB674191C/18/FTFX:674191FX TRF : MC ALISTER NIGERIA LIMITED/SHAHIN ESTABLISHMENT FOR IMPORT AND EXPORT
7-Aug-18,0,7-Aug-18,50,,"372,395.41",STAMP DUTY CHARGE 07082018 STAMP DUTY CHARGE - 07/08/2018
8-Aug-18,886,8-Aug-18,"100,000.00",,"272,395.41",CHEQUE DEPOSIT CHQ DEP FRM MC ALISTER NIGERIA LIMITED TO THE DEW POINT TECHNICAL SERV REF:214077333400001000001808081444
9-Aug-18,887,9-Aug-18,"150,000.00",,"122,395.41",CHEQUE DEPOSIT CHQ DEP IFO AGRISCOPIA CO LTD FRM MC ALISTER NIGERIA LIMITED REF:214077333400001500001808091318
9-Aug-18,8606,9-Aug-18,,"1,263,260.00","1,385,655.41",CHEQUE DEPOSIT CHQ DEP IFO MC ALISTER NIG LTD FRM HUBMART STORES LIMITED REF:209076906400012632601808091636
9-Aug-18,0,9-Aug-18,50,,"1,385,605.41",STAMP DUTY CHARGE 09082018 STAMP DUTY CHARGE - 09/08/2018
10-Aug-18,888,10-Aug-18,"643,535.00",,"742,070.41",CHEQUE DEPOSIT CHQ DEP FRM MC ALISTER NIGERIA LIMITED TO ASKOL NIGERIA LTD REF:214077333400006435351808101403
13-Aug-18,0,13-Aug-18,"17,347.00",,"724,723.41",COMMISSION FOR SWIFT TRANSFER GTB677316C/18/FTFX:677316FX TRF : MC ALISTER NIGERIA LIMITED/VALSTAR HOLLAND BV
13-Aug-18,0,13-Aug-18,867.35,,"723,856.06",VAT ON COMM FOR SWIFT TRANSFER GTB677316C/18/FTFX:677316FX TRF : MC ALISTER NIGERIA LIMITED/VALSTAR HOLLAND BV
13-Aug-18,0,13-Aug-18,"6,000.00",,"717,856.06",SWIFT/TELEX CHARGE GTB677316C/18/FTFX:677316FX TRF : MC ALISTER NIGERIA LIMITED/VALSTAR HOLLAND BV
13-Aug-18,0,13-Aug-18,"8,673.50",,"709,182.56",OVERSEAS BANK CHARGES GTB677316C/18/FTFX:677316FX TRF : MC ALISTER NIGERIA LIMITED/VALSTAR HOLLAND BV
14-Aug-18,8858,14-Aug-18,,"1,211,480.00","1,920,662.56",CHEQUE DEPOSIT CHQ DEP IFO MC ALISTER NIGERIA LIMITED FRM HUBMART STORES LIMITED REF:209076906400012114801808141509
14-Aug-18,0,14-Aug-18,50,,"1,920,612.56",STAMP DUTY CHARGE 14082018 STAMP DUTY CHARGE - 14/08/2018
15-Aug-18,0,15-Aug-18,"17,347.00",,"1,903,265.56",COMMISSION FOR SWIFT TRANSFER GTB678319C/18/FTFX:678319FX TRF : MC ALISTER NIGERIA LIMITED/JITTU HORTICULTURE PLC
15-Aug-18,0,15-Aug-18,867.35,,"1,902,398.21",VAT ON COMM FOR SWIFT TRANSFER GTB678319C/18/FTFX:678319FX TRF : MC ALISTER NIGERIA LIMITED/JITTU HORTICULTURE PLC
15-Aug-18,0,15-Aug-18,"6,000.00",,"1,896,398.21",SWIFT/TELEX CHARGE GTB678319C/18/FTFX:678319FX TRF : MC ALISTER NIGERIA LIMITED/JITTU HORTICULTURE PLC
15-Aug-18,0,15-Aug-18,"8,673.50",,"1,887,724.71",OVERSEAS BANK CHARGES GTB678319C/18/FTFX:678319FX TRF : MC ALISTER NIGERIA LIMITED/JITTU HORTICULTURE PLC
17-Aug-18,889,17-Aug-18,"1,800,000.00",,"87,724.71",CHEQUE DEPOSIT CHQ DEP IFO ASKOL NIGERIA LTD FRM MC ALISTER NIGERIA LIMITED REF:214077333400018000001808171526
24-Aug-18,0,24-Aug-18,,"19,565.00","107,289.71","TRANSFER BETWEEN CUSTOMERS Transfer between customers-Via GTWorld Lomeedar fresh order REF:441339599000000195651808241557 from ADIGUN, AMIDAT IFEDOLAPO to MC ALISTER NIGERIA LIMITED"
24-Aug-18,479,24-Aug-18,,"736,950.00","844,239.71",CHEQUE DEPOSIT CHQ DEP IFO MC ALISTER NIGERIA LTD FRM GOODISS SUPERSTORES LTD REF:206025054400007369501808241559
24-Aug-18,0,24-Aug-18,"17,347.00",,"826,892.71",COMMISSION FOR SWIFT TRANSFER GTB684040C/18/FTFX:684040FX TRF : MC ALISTER NIGERIA LIMITED/BE-FRESH PRODUCE BV
24-Aug-18,0,24-Aug-18,867.35,,"826,025.36",VAT ON COMM FOR SWIFT TRANSFER GTB684040C/18/FTFX:684040FX TRF : MC ALISTER NIGERIA LIMITED/BE-FRESH PRODUCE BV
24-Aug-18,0,24-Aug-18,"6,000.00",,"820,025.36",SWIFT/TELEX CHARGE GTB684040C/18/FTFX:684040FX TRF : MC ALISTER NIGERIA LIMITED/BE-FRESH PRODUCE BV
24-Aug-18,0,24-Aug-18,"8,673.50",,"811,351.86",OVERSEAS BANK CHARGES GTB684040C/18/FTFX:684040FX TRF : MC ALISTER NIGERIA LIMITED/BE-FRESH PRODUCE BV
24-Aug-18,8956,24-Aug-18,,"1,216,020.00","2,027,371.86",CHEQUE DEPOSIT CHQ DEP IFO MC ALISTER NIG LTD REF:209076906400012160201808241806
24-Aug-18,0,24-Aug-18,100,,"2,027,271.86",STAMP DUTY CHARGE 24082018 STAMP DUTY CHARGE - 24/08/2018
27-Aug-18,0,27-Aug-18,,"60,700.00","2,087,971.86",TRANSFER BETWEEN CUSTOMERS via GAPS 636709580092844555-1   from ROMA FRUIT OF NATURE LIMITED to MC ALISTER NIGERIA LIMITED REF: 0013888548913299080000000
27-Aug-18,0,27-Aug-18,,"35,700.00","2,123,671.86","TRANSFER BETWEEN CUSTOMERS MBANKING - MC ALISTER 7b Sapara williams ANY Account Transfer from ONI, YEMI to MC ALISTER NIGERIA LIMITED"
27-Aug-18,0,27-Aug-18,"2,000.00",,"2,121,671.86",Cheque Book Request Commission Being charge for Chequebook Request - Cheque Leave(s) 901 to 1000
27-Aug-18,0,27-Aug-18,100,,"2,121,571.86",VALUE ADDED TAX k Request - Cheque Leave(s) 90
27-Aug-18,890,27-Aug-18,"1,900,000.00",,"221,571.86",CHEQUE DEPOSIT CHQ DEP FRM MC ALISTER NIG LTD TO 4BOYZ ENT.
27-Aug-18,0,27-Aug-18,"17,460.00",,"204,111.86",COMMISSION FOR SWIFT TRANSFER GTB685079C/18/FTFX:685079FX TRF : MC ALISTER NIGERIA LIMITED/VALSTAR HOLLAND BV
27-Aug-18,0,27-Aug-18,873,,"203,238.86",VAT ON COMM FOR SWIFT TRANSFER GTB685079C/18/FTFX:685079FX TRF : MC ALISTER NIGERIA LIMITED/VALSTAR HOLLAND BV
27-Aug-18,0,27-Aug-18,"6,000.00",,"197,238.86",SWIFT/TELEX CHARGE GTB685079C/18/FTFX:685079FX TRF : MC ALISTER NIGERIA LIMITED/VALSTAR HOLLAND BV
27-Aug-18,0,27-Aug-18,"8,730.00",,"188,508.86",OVERSEAS BANK CHARGES GTB685079C/18/FTFX:685079FX TRF : MC ALISTER NIGERIA LIMITED/VALSTAR HOLLAND BV
27-Aug-18,0,27-Aug-18,50,,"188,458.86",STAMP DUTY CHARGE 27082018 STAMP DUTY CHARGE - 27/08/2018
29-Aug-18,1159,29-Aug-18,,"78,000.00","266,458.86",CHEQUE DEPOSIT CHQ DEP FRM PEARL GARDEN CHINESE REST.LTD TO MC ALISTER NIGERIA LIMITED REF:202014806700000780001808291440
29-Aug-18,0,29-Aug-18,50,,"266,408.86",STAMP DUTY CHARGE 29082018 STAMP DUTY CHARGE - 29/08/2018
30-Aug-18,0,30-Aug-18,"17,460.00",,"248,948.86",COMMISSION FOR SWIFT TRANSFER GTB687380C/18/FTFX:687380FX TRF : MC ALISTER NIGERIA LIMITED/JITTU HORTICULTURE PLC
30-Aug-18,0,30-Aug-18,873,,"248,075.86",VAT ON COMM FOR SWIFT TRANSFER GTB687380C/18/FTFX:687380FX TRF : MC ALISTER NIGERIA LIMITED/JITTU HORTICULTURE PLC
30-Aug-18,0,30-Aug-18,"6,000.00",,"242,075.86",SWIFT/TELEX CHARGE GTB687380C/18/FTFX:687380FX TRF : MC ALISTER NIGERIA LIMITED/JITTU HORTICULTURE PLC
30-Aug-18,0,30-Aug-18,"8,730.00",,"233,345.86",OVERSEAS BANK CHARGES GTB687380C/18/FTFX:687380FX TRF : MC ALISTER NIGERIA LIMITED/JITTU HORTICULTURE PLC
1-Sep-18,0,31-Aug-18,"5,478.54",,"227,867.32",ACCOUNT MAINTENANCE CHARGE
1-Sep-18,0,31-Aug-18,273.93,,"227,593.39",VALUE ADDED TAX
3-Sep-18,891,3-Sep-18,"150,000.00",,"77,593.39",CASH WITHDRAWAL PATIENCE UDOH
5-Sep-18,0,5-Sep-18,"17,460.00",,"60,133.39",COMMISSION FOR SWIFT TRANSFER GTB690828C/18/FTFX:690828FX TRF : MC ALISTER NIGERIA LIMITED/VALSTAR HOLLAND BV
5-Sep-18,0,5-Sep-18,873,,"59,260.39",VAT ON COMM FOR SWIFT TRANSFER GTB690828C/18/FTFX:690828FX TRF : MC ALISTER NIGERIA LIMITED/VALSTAR HOLLAND BV
5-Sep-18,0,5-Sep-18,"6,000.00",,"53,260.39",SWIFT/TELEX CHARGE GTB690828C/18/FTFX:690828FX TRF : MC ALISTER NIGERIA LIMITED/VALSTAR HOLLAND BV
5-Sep-18,0,5-Sep-18,"8,730.00",,"44,530.39",OVERSEAS BANK CHARGES GTB690828C/18/FTFX:690828FX TRF : MC ALISTER NIGERIA LIMITED/VALSTAR HOLLAND BV
8-Sep-18,0,10-Sep-18,,"31,320.00","75,850.39","TRANSFER BETWEEN CUSTOMERS MBANKING - Invoice No 0004154 ANY Account Transfer from IBRU, EDESIRI ONATEJIROGHENE to MC ALISTER NIGERIA LIMITED"
10-Sep-18,546,10-Sep-18,,"120,500.00","196,350.39",CHEQUE DEPOSIT CHQ IFO MC ALISTER NIGERIA LIMITED FRM MALLMART YABA REF:246024179800001205001809101507
10-Sep-18,192,10-Sep-18,,"95,100.00","291,450.39",CHEQUE DEPOSIT CHQ IFO MC ALISTER NIGERIA LIMITED FRM MALLMART YABA REF:246024179800000951001809101512
10-Sep-18,193,10-Sep-18,,"15,000.00","306,450.39",CHEQUE DEPOSIT CHQ IFO MC ALISTER NIGERIA LIMITED FRM MALLMART YABA REF:246024179800000150001809101514
10-Sep-18,0,10-Sep-18,,"19,200.00","325,650.39",TRANSFER BETWEEN CUSTOMERS USSD GTBank Transfer from : 09097958680 ONI FELIX IGIANU to MC ALISTER NIGERIA LIMITED 2250938010000001920008159439
10-Sep-18,0,10-Sep-18,200,,"325,450.39",STAMP DUTY CHARGE 10092018 STAMP DUTY CHARGE - 10/09/2018
11-Sep-18,9087,11-Sep-18,,"2,565,600.00","2,891,050.39",CHEQUE DEPOSIT CHQ DEP FRM HUBMART STORES LIMITED TO MC ALISTER NIGERIA LIMITED REF:209076906400025656001809111152
11-Sep-18,893,11-Sep-18,"2,600,000.00",,"291,050.39",CHEQUE DEPOSIT CHQ DEP IFO 4BOYZ ENTERPRISE FRM MC ALISTER NIGERIA LIMITED REF:214077333400026000001809111611
11-Sep-18,0,11-Sep-18,"17,460.00",,"273,590.39",COMMISSION FOR SWIFT TRANSFER GTB694450C/18/FTFX:694450FX TRF : MC ALISTER NIGERIA LIMITED/VALSTAR HOLLAND BV
11-Sep-18,0,11-Sep-18,873,,"272,717.39",VAT ON COMM FOR SWIFT TRANSFER GTB694450C/18/FTFX:694450FX TRF : MC ALISTER NIGERIA LIMITED/VALSTAR HOLLAND BV
11-Sep-18,0,11-Sep-18,"6,000.00",,"266,717.39",SWIFT/TELEX CHARGE GTB694450C/18/FTFX:694450FX TRF : MC ALISTER NIGERIA LIMITED/VALSTAR HOLLAND BV
11-Sep-18,0,11-Sep-18,"8,730.00",,"257,987.39",OVERSEAS BANK CHARGES GTB694450C/18/FTFX:694450FX TRF : MC ALISTER NIGERIA LIMITED/VALSTAR HOLLAND BV
11-Sep-18,0,11-Sep-18,50,,"257,937.39",STAMP DUTY CHARGE 11092018 STAMP DUTY CHARGE - 11/09/2018
12-Sep-18,894,12-Sep-18,"45,000.00",,"212,937.39",CHEQUE DEPOSIT CHQ DEP FRM MC ALISTER NIGERIA LIMITED TO QUALITY ZONE NIGERIA LTD REF:214077333400000450001809121255
14-Sep-18,9159,14-Sep-18,,"1,101,660.00","1,314,597.39",CHEQUE DEPOSIT CHQ DEP FRM HUBMART STORES LIMITED TO MC ALISTER NIGERIA LIMITED REF:209076906400011016601809141446
14-Sep-18,0,14-Sep-18,"17,460.00",,"1,297,137.39",COMMISSION FOR SWIFT TRANSFER GTB697006C/18/FTFX:697006FX TRF : MC ALISTER NIGERIA LIMITED/VALSTAR HOLLAND BV
14-Sep-18,0,14-Sep-18,873,,"1,296,264.39",VAT ON COMM FOR SWIFT TRANSFER GTB697006C/18/FTFX:697006FX TRF : MC ALISTER NIGERIA LIMITED/VALSTAR HOLLAND BV
14-Sep-18,0,14-Sep-18,"6,000.00",,"1,290,264.39",SWIFT/TELEX CHARGE GTB697006C/18/FTFX:697006FX TRF : MC ALISTER NIGERIA LIMITED/VALSTAR HOLLAND BV
14-Sep-18,0,14-Sep-18,"8,730.00",,"1,281,534.39",OVERSEAS BANK CHARGES GTB697006C/18/FTFX:697006FX TRF : MC ALISTER NIGERIA LIMITED/VALSTAR HOLLAND BV
14-Sep-18,0,14-Sep-18,50,,"1,281,484.39",STAMP DUTY CHARGE 14092018 STAMP DUTY CHARGE - 14/09/2018
16-Sep-18,0,17-Sep-18,,"17,200.00","1,298,684.39",TRANSFER BETWEEN CUSTOMERS via GAPS 636726941202858563-1   from ROMA FRUIT OF NATURE LIMITED to MC ALISTER NIGERIA LIMITED REF: 0013888548112840620000000
17-Sep-18,191,17-Sep-18,,"76,000.00","1,374,684.39",CHEQUE DEPOSIT CHQ DEP IFO MC ALISTER NIGERIA LTD FRM MALLMART YABA REF:246024179800000760001809170940
17-Sep-18,195,17-Sep-18,,"38,000.00","1,412,684.39",CHEQUE DEPOSIT CHQ DEP IFO MC ALISTER NIGERIA LTD FRM MALLMART YABA REF:246024179800000380001809170941
17-Sep-18,194,17-Sep-18,,"58,600.00","1,471,284.39",CHEQUE DEPOSIT CHQ DEP IFO MC ALISTER NIGERIA LTD FRM MALLMART YABA REF:246024179800000586001809170947
17-Sep-18,190,17-Sep-18,,"61,000.00","1,532,284.39",CHEQUE DEPOSIT CHQ DEP IFO MC ALISTER NIGERIA LTD FRM MALLMART YABA REF:246024179800000610001809170950
17-Sep-18,895,17-Sep-18,"1,300,000.00",,"232,284.39",CHEQUE DEPOSIT CHQ DEP FRM MC ALISTER NIG LTD TO 4BOYZ ENT.
17-Sep-18,0,17-Sep-18,"17,460.00",,"214,824.39",COMMISSION FOR SWIFT TRANSFER GTB698110C/18/FTFX:698110FX TRF : MC ALISTER NIGERIA LIMITED/VALSTAR HOLLAND BV
17-Sep-18,0,17-Sep-18,873,,"213,951.39",VAT ON COMM FOR SWIFT TRANSFER GTB698110C/18/FTFX:698110FX TRF : MC ALISTER NIGERIA LIMITED/VALSTAR HOLLAND BV
17-Sep-18,0,17-Sep-18,"6,000.00",,"207,951.39",SWIFT/TELEX CHARGE GTB698110C/18/FTFX:698110FX TRF : MC ALISTER NIGERIA LIMITED/VALSTAR HOLLAND BV
17-Sep-18,0,17-Sep-18,"8,730.00",,"199,221.39",OVERSEAS BANK CHARGES GTB698110C/18/FTFX:698110FX TRF : MC ALISTER NIGERIA LIMITED/VALSTAR HOLLAND BV
17-Sep-18,0,17-Sep-18,250,,"198,971.39",STAMP DUTY CHARGE 17092018 STAMP DUTY CHARGE - 17/09/2018
18-Sep-18,9158,18-Sep-18,,"2,561,070.00","2,760,041.39",CHEQUE DEPOSIT CHQ DEP IFO MC ALISTER NIG LTD FRM HUBMART STORES LTD REF:209076906400025610701809181503
18-Sep-18,0,18-Sep-18,50,,"2,759,991.39",STAMP DUTY CHARGE 18092018 STAMP DUTY CHARGE - 18/09/2018
19-Sep-18,896,19-Sep-18,"2,600,000.00",,"159,991.39",CHEQUE DEPOSIT CHQ DEP IFO 4BOYZ ENTERPRISE FRM MC ALISTER NIGERIA LIMITED REF:214077333400026000001809191256
19-Sep-18,0,19-Sep-18,"17,460.00",,"142,531.39",COMMISSION FOR SWIFT TRANSFER GTB699901C/18/FTFX:699901FX TRF : MC ALISTER NIGERIA LIMITED/VALSTAR HOLLAND BV
19-Sep-18,0,19-Sep-18,873,,"141,658.39",VAT ON COMM FOR SWIFT TRANSFER GTB699901C/18/FTFX:699901FX TRF : MC ALISTER NIGERIA LIMITED/VALSTAR HOLLAND BV
19-Sep-18,0,19-Sep-18,"6,000.00",,"135,658.39",SWIFT/TELEX CHARGE GTB699901C/18/FTFX:699901FX TRF : MC ALISTER NIGERIA LIMITED/VALSTAR HOLLAND BV
19-Sep-18,0,19-Sep-18,"8,730.00",,"126,928.39",OVERSEAS BANK CHARGES GTB699901C/18/FTFX:699901FX TRF : MC ALISTER NIGERIA LIMITED/VALSTAR HOLLAND BV
21-Sep-18,0,21-Sep-18,"17,460.00",,"109,468.39",COMMISSION FOR SWIFT TRANSFER GTB701136C/18/FTFX:701136FX TRF : MC ALISTER NIGERIA LIMITED/VALSTAR HOLLAND BV
21-Sep-18,0,21-Sep-18,873,,"108,595.39",VAT ON COMM FOR SWIFT TRANSFER GTB701136C/18/FTFX:701136FX TRF : MC ALISTER NIGERIA LIMITED/VALSTAR HOLLAND BV
21-Sep-18,0,21-Sep-18,"6,000.00",,"102,595.39",SWIFT/TELEX CHARGE GTB701136C/18/FTFX:701136FX TRF : MC ALISTER NIGERIA LIMITED/VALSTAR HOLLAND BV
21-Sep-18,0,21-Sep-18,"8,730.00",,"93,865.39",OVERSEAS BANK CHARGES GTB701136C/18/FTFX:701136FX TRF : MC ALISTER NIGERIA LIMITED/VALSTAR HOLLAND BV
21-Sep-18,0,21-Sep-18,,"12,190.00","106,055.39",TRANSFER BETWEEN CUSTOMERS Transfer between customers-Via GTWorld Fruits for module 23 Oct job REF:202310016000000121901809211620 from LO'MEEDAR FRESH to MC ALISTER NIGERIA LIMITED
21-Sep-18,0,21-Sep-18,50,,"106,005.39",STAMP DUTY CHARGE 21092018 STAMP DUTY CHARGE - 21/09/2018
24-Sep-18,0,24-Sep-18,,"2,115,190.00","2,221,195.39",TRANSFER BETWEEN CUSTOMERS via GAPS supply on 51365301 SUPPLY from HUBMART STORES LIMITED to MC ALISTER NIGERIA LIMITED REF: 0208992045513653010000000
24-Sep-18,0,24-Sep-18,50,,"2,221,145.39",STAMP DUTY CHARGE 24092018 STAMP DUTY CHARGE - 24/09/2018
26-Sep-18,897,26-Sep-18,"2,100,000.00",,"121,145.39",CHEQUE DEPOSIT CHQ DEP IFO 4BOYZ ENTERPRISE FRM MC ALISTER NIGERIA LIMITED REF:214077333400021000001809261504
26-Sep-18,0,26-Sep-18,"17,460.00",,"103,685.39",COMMISSION FOR SWIFT TRANSFER GTB703998C/18/FTFX:703998FX TRF : MC ALISTER NIGERIA LIMITED/VALSTAR HOLLAND BV
26-Sep-18,0,26-Sep-18,873,,"102,812.39",VAT ON COMM FOR SWIFT TRANSFER GTB703998C/18/FTFX:703998FX TRF : MC ALISTER NIGERIA LIMITED/VALSTAR HOLLAND BV
26-Sep-18,0,26-Sep-18,"6,000.00",,"96,812.39",SWIFT/TELEX CHARGE GTB703998C/18/FTFX:703998FX TRF : MC ALISTER NIGERIA LIMITED/VALSTAR HOLLAND BV
26-Sep-18,0,26-Sep-18,"8,730.00",,"88,082.39",OVERSEAS BANK CHARGES GTB703998C/18/FTFX:703998FX TRF : MC ALISTER NIGERIA LIMITED/VALSTAR HOLLAND BV
27-Sep-18,1049,27-Sep-18,,"166,410.00","254,492.39",CHEQUE DEPOSIT CHQ DEP FRM PREMIER CORP. FORTE NIG. LTD TO MC ALISTER NIGERIA LIMITED REF:209074241600001664101809271520
27-Sep-18,9244,27-Sep-18,,"1,612,020.00","1,866,512.39",CHEQUE DEPOSIT CHQ DEP IFO MC ALISTER NIG LTD FRM HUBMART STORES LTD REF:209076906400016120201809271608
27-Sep-18,0,27-Sep-18,100,,"1,866,412.39",STAMP DUTY CHARGE 27092018 STAMP DUTY CHARGE - 27/09/2018
28-Sep-18,898,28-Sep-18,"1,720,540.00",,"145,872.39",CHEQUE DEPOSIT CHQ DEP FRM MC ALISTER NIGERIA LIMITED TO ASKOL NIGERIA LTD REF:214077333400017205401809281543
29-Sep-18,0,28-Sep-18,"10,515.54",,"135,356.85",ACCOUNT MAINTENANCE CHARGE
29-Sep-18,0,28-Sep-18,525.78,,"134,831.07",VALUE ADDED TAX
2-Oct-18,0,2-Oct-18,,"3,750.00","138,581.07",TRANSFER BETWEEN CUSTOMERS USSD GTBank Transfer from : 08027643804 RAHEEM ADEYEMISI to MC ALISTER NIGERIA LIMITED 205013690100000037500841771966 from RAHEEM ADEYEMISI to MC ALISTER NIGERIA LIMITED
2-Oct-18,0,2-Oct-18,"17,725.00",,"120,856.07",COMMISSION FOR SWIFT TRANSFER GTB707047C/18/FTFX:707047FX TRF : MC ALISTER NIGERIA LIMITED/VALSTAR HOLLAND BV
2-Oct-18,0,2-Oct-18,886.25,,"119,969.82",VAT ON COMM FOR SWIFT TRANSFER GTB707047C/18/FTFX:707047FX TRF : MC ALISTER NIGERIA LIMITED/VALSTAR HOLLAND BV
2-Oct-18,0,2-Oct-18,"6,000.00",,"113,969.82",SWIFT/TELEX CHARGE GTB707047C/18/FTFX:707047FX TRF : MC ALISTER NIGERIA LIMITED/VALSTAR HOLLAND BV
2-Oct-18,0,2-Oct-18,"8,862.50",,"105,107.32",OVERSEAS BANK CHARGES GTB707047C/18/FTFX:707047FX TRF : MC ALISTER NIGERIA LIMITED/VALSTAR HOLLAND BV
2-Oct-18,0,2-Oct-18,50,,"105,057.32",STAMP DUTY CHARGE 02102018 STAMP DUTY CHARGE - 02/10/2018
3-Oct-18,9243,3-Oct-18,,"2,026,000.00","2,131,057.32",CHEQUE DEPOSIT CHQ DEP FRM HUBMART STORES LIMITED TO MC ALISTER NIGERIA LIMITED REF:209076906400020260001810031449
3-Oct-18,899,3-Oct-18,"2,000,000.00",,"131,057.32",CHEQUE DEPOSIT CHQ DEP IFO 4BOYZ ENTERPRISE FRM MC ALISTER NIGERIA LIMITED
3-Oct-18,0,3-Oct-18,50,,"131,007.32",STAMP DUTY CHARGE 03102018 STAMP DUTY CHARGE - 03/10/2018
5-Oct-18,667,5-Oct-18,,"19,000.00","150,007.32",CHEQUE DEPOSIT CHQ DEP FRM MALLMART YABA TO MC ALISTER NIGERIA LIMITED REF:246024179800000190001810050830
5-Oct-18,451,5-Oct-18,,"71,000.00","221,007.32",CHEQUE DEPOSIT CHQ DEP IFO MC ALISTER NIGERIA LIMITED FRM MALLMART YABA REF:246024179800000710001810050838
5-Oct-18,900,5-Oct-18,"50,000.00",,"171,007.32",CHEQUE DEPOSIT CHQ DEP IFO QUADRI OLAWALE FRM MC ALISTER NIGERIA LIMITED REF:214077333400000500001810051457
5-Oct-18,664,5-Oct-18,,"61,000.00","232,007.32",CHEQUE DEPOSIT CHQ DEP IFO MC ALISTER NIGERIA LIMITED FRM MALLMART YABA REF:246024179800000610001810051727
5-Oct-18,665,5-Oct-18,,"42,000.00","274,007.32",CHEQUE DEPOSIT CHQ DEP IFO MC ALISTER NIGERIA LIMITED FRM MALLMART YABA REF:246024179800000420001810051729
5-Oct-18,433,5-Oct-18,,"47,000.00","321,007.32",CHEQUE DEPOSIT CHQ DEP IFO MC ALISTER NIGERIA LIMITED FRM MALLMART YABA REF:246024179800000470001810051731
5-Oct-18,414,5-Oct-18,,"70,000.00","391,007.32",CHEQUE DEPOSIT CHQ DEP IFO MC ALISTER NIGERIA LIMITED FRM MALLMART YABA REF:246024179800000700001810051732
5-Oct-18,0,5-Oct-18,300,,"390,707.32",STAMP DUTY CHARGE 05102018 STAMP DUTY CHARGE - 05/10/2018
8-Oct-18,0,8-Oct-18,,"6,200.00","396,907.32","TRANSFER BETWEEN CUSTOMERS MBANKING - From Jenny Benoit ANY Account Transfer from ASSAF,ROY ZIAD to MC ALISTER NIGERIA LIMITED"
8-Oct-18,663,8-Oct-18,,"42,000.00","438,907.32",CHEQUE DEPOSIT CHQ DEP IFO MC ALISTER NIGERIA LIMITED FRM MALLMART YABA REF:246024179800000420001810081258
8-Oct-18,662,8-Oct-18,,"53,000.00","491,907.32",CHEQUE DEPOSIT CHQ DEP IFO MC ALISTER NIGERIA LIMITED FRM MALLMART YABA REF:246024179800000530001810081259
8-Oct-18,668,8-Oct-18,,"21,000.00","512,907.32",CHEQUE DEPOSIT CHQ DEP IFO MC ALISTER NIGERIA LIMITED FRM MALLMART YABA REF:246024179800000210001810081300
8-Oct-18,431,8-Oct-18,,"76,000.00","588,907.32",CHEQUE DEPOSIT CHQ DEP IFO MC ALISTER NIGERIA LIMITED FRM MALLMART YABA REF:246024179800000760001810081302
8-Oct-18,0,8-Oct-18,"17,725.00",,"571,182.32",COMMISSION FOR SWIFT TRANSFER GTB710566C/18/FTFX:710566FX TRF : MC ALISTER NIGERIA LIMITED/VALSTAR HOLLAND BV
8-Oct-18,0,8-Oct-18,886.25,,"570,296.07",VAT ON COMM FOR SWIFT TRANSFER GTB710566C/18/FTFX:710566FX TRF : MC ALISTER NIGERIA LIMITED/VALSTAR HOLLAND BV
8-Oct-18,0,8-Oct-18,"6,000.00",,"564,296.07",SWIFT/TELEX CHARGE GTB710566C/18/FTFX:710566FX TRF : MC ALISTER NIGERIA LIMITED/VALSTAR HOLLAND BV
8-Oct-18,0,8-Oct-18,"8,862.50",,"555,433.57",OVERSEAS BANK CHARGES GTB710566C/18/FTFX:710566FX TRF : MC ALISTER NIGERIA LIMITED/VALSTAR HOLLAND BV
8-Oct-18,0,8-Oct-18,250,,"555,183.57",STAMP DUTY CHARGE 08102018 STAMP DUTY CHARGE - 08/10/2018
9-Oct-18,0,9-Oct-18,"17,725.00",,"537,458.57",COMMISSION FOR SWIFT TRANSFER GTB711459C/18/FTFX:711459FX TRF : MC ALISTER NIGERIA LIMITED/JITTU HORTICULTURE PLC
9-Oct-18,0,9-Oct-18,886.25,,"536,572.32",VAT ON COMM FOR SWIFT TRANSFER GTB711459C/18/FTFX:711459FX TRF : MC ALISTER NIGERIA LIMITED/JITTU HORTICULTURE PLC
9-Oct-18,0,9-Oct-18,"6,000.00",,"530,572.32",SWIFT/TELEX CHARGE GTB711459C/18/FTFX:711459FX TRF : MC ALISTER NIGERIA LIMITED/JITTU HORTICULTURE PLC
9-Oct-18,0,9-Oct-18,"8,862.50",,"521,709.82",OVERSEAS BANK CHARGES GTB711459C/18/FTFX:711459FX TRF : MC ALISTER NIGERIA LIMITED/JITTU HORTICULTURE PLC
11-Oct-18,20241,12-Oct-18,,"152,600.00","674,309.82","CLEARING DEPOSIT, DR A/C IN LOCAL BRANCH ECO|RENEE MALLS LIMITED Ref:OBC121477333411020241000000000"
11-Oct-18,9387,11-Oct-18,,"2,111,620.00","2,785,929.82",CHEQUE DEPOSIT FRM HUBMART STORES LIMITED TO MC ALISTER NIGERIA LIMITED REF:209076906400021116201810111334
11-Oct-18,0,11-Oct-18,100,,"2,785,829.82",STAMP DUTY CHARGE 11102018 STAMP DUTY CHARGE - 11/10/2018
12-Oct-18,0,12-Oct-18,"17,725.00",,"2,768,104.82",COMMISSION FOR SWIFT TRANSFER GTB713681C/18/FTFX:713681FX TRF : MC ALISTER NIGERIA LIMITED/VALSTAR HOLLAND BV
12-Oct-18,0,12-Oct-18,886.25,,"2,767,218.57",VAT ON COMM FOR SWIFT TRANSFER GTB713681C/18/FTFX:713681FX TRF : MC ALISTER NIGERIA LIMITED/VALSTAR HOLLAND BV
12-Oct-18,0,12-Oct-18,"6,000.00",,"2,761,218.57",SWIFT/TELEX CHARGE GTB713681C/18/FTFX:713681FX TRF : MC ALISTER NIGERIA LIMITED/VALSTAR HOLLAND BV
12-Oct-18,0,12-Oct-18,"8,862.50",,"2,752,356.07",OVERSEAS BANK CHARGES GTB713681C/18/FTFX:713681FX TRF : MC ALISTER NIGERIA LIMITED/VALSTAR HOLLAND BV
12-Oct-18,0,12-Oct-18,,"24,200.00","2,776,556.07",TRANSFER BETWEEN CUSTOMERS via GAPS 636749520871433785-1   from ROMA FRUIT OF NATURE LIMITED to MC ALISTER NIGERIA LIMITED REF: 0013888548144127753000000
12-Oct-18,901,12-Oct-18,"2,500,000.00",,"276,556.07",CHEQUE DEPOSIT CHQ DEP IFO 4BOYZ ENTERPRISE FRM MC ALISTER NIGERIA LIMITED REF:214077333400025000001810121614
12-Oct-18,0,12-Oct-18,50,,"276,506.07",STAMP DUTY CHARGE 12102018 STAMP DUTY CHARGE - 12/10/2018
16-Oct-18,0,16-Oct-18,"17,725.00",,"258,781.07",COMMISSION FOR SWIFT TRANSFER GTB714840C/18/FTFX:714840FX TRF : MC ALISTER NIGERIA LIMITED/VALSATAR HOLLAND BV
16-Oct-18,0,16-Oct-18,886.25,,"257,894.82",VAT ON COMM FOR SWIFT TRANSFER GTB714840C/18/FTFX:714840FX TRF : MC ALISTER NIGERIA LIMITED/VALSATAR HOLLAND BV
16-Oct-18,0,16-Oct-18,"6,000.00",,"251,894.82",SWIFT/TELEX CHARGE GTB714840C/18/FTFX:714840FX TRF : MC ALISTER NIGERIA LIMITED/VALSATAR HOLLAND BV
17-Oct-18,9792,17-Oct-18,,"3,170,100.00","3,421,994.82",CHEQUE DEPOSIT CHQ DEP IFO MC ALISTER NIG LTD FRM HUBMART STORES LIMITED REF:209076906400031701001810171421
17-Oct-18,902,17-Oct-18,"3,200,000.00",,"221,994.82",CHEQUE DEPOSIT CHQ DEP IFO 4BOYZ ENTERPRISE FRM MC ALISTER NIGERIA LIMITED
17-Oct-18,0,17-Oct-18,50,,"221,944.82",STAMP DUTY CHARGE 17102018 STAMP DUTY CHARGE - 17/10/2018
18-Oct-18,0,18-Oct-18,"17,725.00",,"204,219.82",COMMISSION FOR SWIFT TRANSFER GTB717432C/18/FTFX:717432FX TRF : MC ALISTER NIGERIA LIMITED/VALSTAR HOLLAND BV
18-Oct-18,0,18-Oct-18,886.25,,"203,333.57",VAT ON COMM FOR SWIFT TRANSFER GTB717432C/18/FTFX:717432FX TRF : MC ALISTER NIGERIA LIMITED/VALSTAR HOLLAND BV
18-Oct-18,0,18-Oct-18,"6,000.00",,"197,333.57",SWIFT/TELEX CHARGE GTB717432C/18/FTFX:717432FX TRF : MC ALISTER NIGERIA LIMITED/VALSTAR HOLLAND BV
18-Oct-18,0,18-Oct-18,"8,862.50",,"188,471.07",OVERSEAS BANK CHARGES GTB717432C/18/FTFX:717432FX TRF : MC ALISTER NIGERIA LIMITED/VALSTAR HOLLAND BV
19-Oct-18,0,19-Oct-18,"17,725.00",,"170,746.07",COMMISSION FOR SWIFT TRANSFER GTB718442C/18/FTFX:718442FX TRF : MC ALISTER NIGERIA LIMITED/JITTU HORTICULTURE PLC
19-Oct-18,0,19-Oct-18,886.25,,"169,859.82",VAT ON COMM FOR SWIFT TRANSFER GTB718442C/18/FTFX:718442FX TRF : MC ALISTER NIGERIA LIMITED/JITTU HORTICULTURE PLC
19-Oct-18,0,19-Oct-18,"6,000.00",,"163,859.82",SWIFT/TELEX CHARGE GTB718442C/18/FTFX:718442FX TRF : MC ALISTER NIGERIA LIMITED/JITTU HORTICULTURE PLC
19-Oct-18,0,19-Oct-18,"8,862.50",,"154,997.32",OVERSEAS BANK CHARGES GTB718442C/18/FTFX:718442FX TRF : MC ALISTER NIGERIA LIMITED/JITTU HORTICULTURE PLC
22-Oct-18,0,22-Oct-18,"17,725.00",,"137,272.32",COMMISSION FOR SWIFT TRANSFER GTB719128C/18/FTFX:719128FX TRF : MC ALISTER NIGERIA LIMITED/VALSTAR HOLLAND BV
22-Oct-18,0,22-Oct-18,886.25,,"136,386.07",VAT ON COMM FOR SWIFT TRANSFER GTB719128C/18/FTFX:719128FX TRF : MC ALISTER NIGERIA LIMITED/VALSTAR HOLLAND BV
22-Oct-18,0,22-Oct-18,"6,000.00",,"130,386.07",SWIFT/TELEX CHARGE GTB719128C/18/FTFX:719128FX TRF : MC ALISTER NIGERIA LIMITED/VALSTAR HOLLAND BV
22-Oct-18,0,22-Oct-18,"8,862.50",,"121,523.57",OVERSEAS BANK CHARGES GTB719128C/18/FTFX:719128FX TRF : MC ALISTER NIGERIA LIMITED/VALSTAR HOLLAND BV
23-Oct-18,9536,23-Oct-18,,"2,125,040.00","2,246,563.57",CHEQUE DEPOSIT CHQ IFO MC ALISTER NIGERIA LIMITED FRM HUBMART STORES LIMITED REF:209076906400021250401810231418
23-Oct-18,0,23-Oct-18,50,,"2,246,513.57",STAMP DUTY CHARGE 23102018 STAMP DUTY CHARGE - 23/10/2018
25-Oct-18,903,25-Oct-18,"30,000.00",,"2,216,513.57",TRANSFER BETWEEN CUSTOMERS TRF IFO MUSIBAU ADEBESHI FRM MC ALISTER NIGERIA LTD
26-Oct-18,904,26-Oct-18,"300,000.00",,"1,916,513.57",CHEQUE DEPOSIT CHQ DEP IFO ASKOL NIGERIA LTD FRM MC ALISTER NIGERIA LIMITED
26-Oct-18,905,26-Oct-18,"1,752,500.00",,"164,013.57",CHEQUE DEPOSIT CHQ DEP IFO 4BOYZ ENTERPRISE FRM MC ALISTER NIGERIA LIMITED
29-Oct-18,0,29-Oct-18,,"34,245.00","198,258.57","TRANSFER BETWEEN CUSTOMERS MBANKING - ANY Account Transfer from IBRU, EDESIRI ONATEJIROGHENE to MC ALISTER NIGERIA LIMITED"
29-Oct-18,0,29-Oct-18,"17,877.50",,"180,381.07",COMMISSION FOR SWIFT TRANSFER GTB723836C/18/FTFX:723836FX TRF : MC ALISTER NIGERIA LIMITED/VALSTAR HOLLAND BV
29-Oct-18,0,29-Oct-18,893.88,,"179,487.19",VAT ON COMM FOR SWIFT TRANSFER GTB723836C/18/FTFX:723836FX TRF : MC ALISTER NIGERIA LIMITED/VALSTAR HOLLAND BV
29-Oct-18,0,29-Oct-18,"6,000.00",,"173,487.19",SWIFT/TELEX CHARGE GTB723836C/18/FTFX:723836FX TRF : MC ALISTER NIGERIA LIMITED/VALSTAR HOLLAND BV
29-Oct-18,0,29-Oct-18,"8,938.75",,"164,548.44",OVERSEAS BANK CHARGES GTB723836C/18/FTFX:723836FX TRF : MC ALISTER NIGERIA LIMITED/VALSTAR HOLLAND BV
29-Oct-18,0,29-Oct-18,50,,"164,498.44",STAMP DUTY CHARGE 29102018 STAMP DUTY CHARGE - 29/10/2018
30-Oct-18,0,30-Oct-18,,"8,964.00","173,462.44","TRANSFER BETWEEN CUSTOMERS MBANKING - ANY Account Transfer from IBRU, EDESIRI ONATEJIROGHENE to MC ALISTER NIGERIA LIMITED"
30-Oct-18,938,30-Oct-18,,"33,000.00","206,462.44",CHEQUE DEPOSIT CHQ DEP FRM MALLMART YABA TO MC ALISTER NIGERIA LIMITED REF:246024179800000330001810301747
30-Oct-18,935,30-Oct-18,,"15,200.00","221,662.44",CHEQUE DEPOSIT CHQ DEP FRM MALLMART YABA TO MC ALISTER NIGERIA LIMITED REF:246024179800000152001810301752
30-Oct-18,0,30-Oct-18,150,,"221,512.44",STAMP DUTY CHARGE 30102018 STAMP DUTY CHARGE - 30/10/2018
31-Oct-18,0,31-Oct-18,"17,877.50",,"203,634.94",COMMISSION FOR SWIFT TRANSFER GTB725520C/18/FTFX:725520FX TRF : MC ALISTER NIGERIA LIMITED/VALSTAR HOLLAND BV
31-Oct-18,0,31-Oct-18,893.88,,"202,741.06",VAT ON COMM FOR SWIFT TRANSFER GTB725520C/18/FTFX:725520FX TRF : MC ALISTER NIGERIA LIMITED/VALSTAR HOLLAND BV
31-Oct-18,0,31-Oct-18,"6,000.00",,"196,741.06",SWIFT/TELEX CHARGE GTB725520C/18/FTFX:725520FX TRF : MC ALISTER NIGERIA LIMITED/VALSTAR HOLLAND BV
31-Oct-18,0,31-Oct-18,"8,938.75",,"187,802.31",OVERSEAS BANK CHARGES GTB725520C/18/FTFX:725520FX TRF : MC ALISTER NIGERIA LIMITED/VALSTAR HOLLAND BV
1-Nov-18,0,31-Oct-18,"9,832.50",,"177,969.81",ACCOUNT MAINTENANCE CHARGE
1-Nov-18,0,31-Oct-18,491.63,,"177,478.18",VALUE ADDED TAX
1-Nov-18,906,1-Nov-18,"150,000.00",,"27,478.18",CASH WITHDRAWAL PATIENCE UDOH
2-Nov-18,0,2-Nov-18,,"25,470.00","52,948.18","TRANSFER BETWEEN CUSTOMERS MBANKING - ANY Account Transfer from IBRU, EDESIRI ONATEJIROGHENE to MC ALISTER NIGERIA LIMITED"
2-Nov-18,0,2-Nov-18,50,,"52,898.18",STAMP DUTY CHARGE 02112018 STAMP DUTY CHARGE - 02/11/2018
9-Nov-18,0,9-Nov-18,"17,892.50",,"35,005.68",COMMISSION FOR SWIFT TRANSFER GTB731902C/18/FTFX:731902FX TRF : MC ALISTER NIGERIA LIMITED/VALSTAR HOLLAND BV
9-Nov-18,0,9-Nov-18,894.63,,"34,111.05",VAT ON COMM FOR SWIFT TRANSFER GTB731902C/18/FTFX:731902FX TRF : MC ALISTER NIGERIA LIMITED/VALSTAR HOLLAND BV
9-Nov-18,0,9-Nov-18,"6,000.00",,"28,111.05",SWIFT/TELEX CHARGE GTB731902C/18/FTFX:731902FX TRF : MC ALISTER NIGERIA LIMITED/VALSTAR HOLLAND BV
9-Nov-18,0,9-Nov-18,"8,946.25",,"19,164.80",OVERSEAS BANK CHARGES GTB731902C/18/FTFX:731902FX TRF : MC ALISTER NIGERIA LIMITED/VALSTAR HOLLAND BV
14-Nov-18,9672,14-Nov-18,,"2,167,730.00","2,186,894.80",CHEQUE DEPOSIT CHQ DEP FRM HUBMART STORES LIMITED TO MC ALISTER NIGERIA LIMITED REF:209076906400021677301811141001
14-Nov-18,0,14-Nov-18,"17,892.50",,"2,169,002.30",COMMISSION FOR SWIFT TRANSFER GTB734519C/18/FTFX:734519FX TRF : MC ALISTER NIGERIA LIMITED/VALSTAR HOLLAND BV
14-Nov-18,0,14-Nov-18,894.63,,"2,168,107.67",VAT ON COMM FOR SWIFT TRANSFER GTB734519C/18/FTFX:734519FX TRF : MC ALISTER NIGERIA LIMITED/VALSTAR HOLLAND BV
14-Nov-18,0,14-Nov-18,"6,000.00",,"2,162,107.67",SWIFT/TELEX CHARGE GTB734519C/18/FTFX:734519FX TRF : MC ALISTER NIGERIA LIMITED/VALSTAR HOLLAND BV
14-Nov-18,0,14-Nov-18,"8,946.25",,"2,153,161.42",OVERSEAS BANK CHARGES GTB734519C/18/FTFX:734519FX TRF : MC ALISTER NIGERIA LIMITED/VALSTAR HOLLAND BV
14-Nov-18,908,14-Nov-18,"2,000,000.00",,"153,161.42",CHEQUE DEPOSIT CHQ DEP IFO 4BOYZ ENTERPRISE FRM MC ALISTER NIGERIA LIMITED REF:214077333400020000001811141709
14-Nov-18,0,14-Nov-18,50,,"153,111.42",STAMP DUTY CHARGE 14112018 STAMP DUTY CHARGE - 14/11/2018
16-Nov-18,0,16-Nov-18,,"65,000.00","218,111.42",TRANSFER BETWEEN CUSTOMERS via GAPS 636779776996579860-1   from ROMA FRUIT OF NATURE LIMITED to MC ALISTER NIGERIA LIMITED REF:228663996000086186511611181508
16-Nov-18,0,16-Nov-18,"17,892.50",,"200,218.92",COMMISSION FOR SWIFT TRANSFER GTB736364C/18/FTFX:736364FX TRF : MC ALISTER NIGERIA LIMITED/VALSTAR HOLLAND BV
16-Nov-18,0,16-Nov-18,894.63,,"199,324.29",VAT ON COMM FOR SWIFT TRANSFER GTB736364C/18/FTFX:736364FX TRF : MC ALISTER NIGERIA LIMITED/VALSTAR HOLLAND BV
16-Nov-18,0,16-Nov-18,"6,000.00",,"193,324.29",SWIFT/TELEX CHARGE GTB736364C/18/FTFX:736364FX TRF : MC ALISTER NIGERIA LIMITED/VALSTAR HOLLAND BV
16-Nov-18,0,16-Nov-18,"8,946.25",,"184,378.04",OVERSEAS BANK CHARGES GTB736364C/18/FTFX:736364FX TRF : MC ALISTER NIGERIA LIMITED/VALSTAR HOLLAND BV
16-Nov-18,0,16-Nov-18,50,,"184,328.04",STAMP DUTY CHARGE 16112018 STAMP DUTY CHARGE - 16/11/2018
19-Nov-18,718,19-Nov-18,,"669,550.00","853,878.04",CHEQUE DEPOSIT CHQ DEP IFO MC ALISTER NIG LTD FRM GOODIS SUPERSTORES LTD
19-Nov-18,0,19-Nov-18,50,,"853,828.04",STAMP DUTY CHARGE 19112018 STAMP DUTY CHARGE - 19/11/2018
21-Nov-18,907,21-Nov-18,"150,000.00",,"703,828.04",CASH WITHDRAWAL PATIENCE UDOH
22-Nov-18,9895,22-Nov-18,,"2,371,800.00","3,075,628.04",CHEQUE DEPOSIT CHQ DEP FRM HUBMART STORES LIMITED TO MC ALISTER NIGERIA LIMITED REF:209076906400023718001811221740
22-Nov-18,0,22-Nov-18,50,,"3,075,578.04",STAMP DUTY CHARGE 22112018 STAMP DUTY CHARGE - 22/11/2018
23-Nov-18,909,23-Nov-18,"681,850.00",,"2,393,728.04",CHEQUE DEPOSIT CHQ DEP IFO ASKOL NIGERIA LTD FRM MC ALISTER NIGERIA LIMITED REF:214077333400006818501811231342
23-Nov-18,910,23-Nov-18,"2,250,000.00",,"143,728.04",CHEQUE DEPOSIT FRM MC ALISTER NIGERIA LIMITED TO 4BOYZ ENTERPRISE REF:214077333400022500001811231548
23-Nov-18,0,23-Nov-18,"17,892.50",,"125,835.54",COMMISSION FOR SWIFT TRANSFER GTB740332C/18/FTFX:740332FX TRF : MC ALISTER NIGERIA LIMITED/VALSTAR HOLLAND BV
23-Nov-18,0,23-Nov-18,894.63,,"124,940.91",VAT ON COMM FOR SWIFT TRANSFER GTB740332C/18/FTFX:740332FX TRF : MC ALISTER NIGERIA LIMITED/VALSTAR HOLLAND BV
23-Nov-18,0,23-Nov-18,"6,000.00",,"118,940.91",SWIFT/TELEX CHARGE GTB740332C/18/FTFX:740332FX TRF : MC ALISTER NIGERIA LIMITED/VALSTAR HOLLAND BV
23-Nov-18,0,23-Nov-18,"8,946.25",,"109,994.66",OVERSEAS BANK CHARGES GTB740332C/18/FTFX:740332FX TRF : MC ALISTER NIGERIA LIMITED/VALSTAR HOLLAND BV
23-Nov-18,772,23-Nov-18,,"534,950.00","644,944.66",CHEQUE DEPOSIT CHQ DEP FRM GOODISS SUPERSTORES LTD TO MC ALISTER NIGERIA LIMITED REF:206025054400005349501811231705
23-Nov-18,0,23-Nov-18,50,,"644,894.66",STAMP DUTY CHARGE 23112018 STAMP DUTY CHARGE - 23/11/2018
26-Nov-18,911,26-Nov-18,"150,000.00",,"494,894.66",CASH WITHDRAWAL PATIENCE UDOH
26-Nov-18,912,26-Nov-18,"150,000.00",,"344,894.66",CASH WITHDRAWAL HILDA TWAKI
26-Nov-18,773,26-Nov-18,,"729,160.00","1,074,054.66",CHEQUE DEPOSIT CHQ DEP FRM GOODISS SUPERSTORES LTD TO MC ALISTER NIGERIA LIMITED REF:206025054400007291601811261540
26-Nov-18,0,26-Nov-18,"17,892.50",,"1,056,162.16",COMMISSION FOR SWIFT TRANSFER GTB741367C/18/FTFX:741367FX TRF : MC ALISTER NIGERIA LIMITED/SHAHIN ESTABLISHMENT FOR IMP. AND EXP
26-Nov-18,0,26-Nov-18,894.63,,"1,055,267.53",VAT ON COMM FOR SWIFT TRANSFER GTB741367C/18/FTFX:741367FX TRF : MC ALISTER NIGERIA LIMITED/SHAHIN ESTABLISHMENT FOR IMP. AND EXP
26-Nov-18,0,26-Nov-18,"6,000.00",,"1,049,267.53",SWIFT/TELEX CHARGE GTB741367C/18/FTFX:741367FX TRF : MC ALISTER NIGERIA LIMITED/SHAHIN ESTABLISHMENT FOR IMP. AND EXP
26-Nov-18,0,26-Nov-18,"8,946.25",,"1,040,321.28",OVERSEAS BANK CHARGES GTB741367C/18/FTFX:741367FX TRF : MC ALISTER NIGERIA LIMITED/SHAHIN ESTABLISHMENT FOR IMP. AND EXP
26-Nov-18,0,26-Nov-18,50,,"1,040,271.28",STAMP DUTY CHARGE 26112018 STAMP DUTY CHARGE - 26/11/2018
29-Nov-18,914,29-Nov-18,"150,000.00",,"890,271.28",CASH WITHDRAWAL HILDA TWAKI
29-Nov-18,913,29-Nov-18,"150,000.00",,"740,271.28",CASH WITHDRAWAL PATIENCE UDOH
29-Nov-18,9980,29-Nov-18,,"2,034,735.00","2,775,006.28",CHEQUE DEPOSIT CHQ DEP FRM HUBMART STORES LTD TO MC ALISTER NIG LTD
29-Nov-18,0,29-Nov-18,50,,"2,774,956.28",STAMP DUTY CHARGE 29112018 STAMP DUTY CHARGE - 29/11/2018
30-Nov-18,915,30-Nov-18,"1,030,125.00",,"1,744,831.28",CHEQUE DEPOSIT FRM MC ALISTER NIGERIA LIMITED TO ASKOL NIGERIA LTD REF:214077333400010301251811301325
30-Nov-18,917,30-Nov-18,"180,000.00",,"1,564,831.28",NIBSS Instant Payment Outward 000013181130133621000206525765 NIP IFO DBN/BOLA TITILAYO MATTEW REF:00001318113013362100020652576
30-Nov-18,917,30-Nov-18,50,,"1,564,781.28",COMMISSION 000013181130133621000206525765 NIP TRANSFER COMMISSION FOR 000013181130133621000206525765 NIP IFO DBN/BOLA TITILAYO MATTEW REF:000013181130133621000206525765
30-Nov-18,917,30-Nov-18,2.5,,"1,564,778.78",VALUE ADDED TAX VAT ON NIP TRANSFER FOR 00001
30-Nov-18,916,30-Nov-18,"360,000.00",,"1,204,778.78",NIBSS Instant Payment Outward 000013181130133821000206527301 NIP IFO DBN/BOLA TITILAYO MATTEW REF:00001318113013382100020652730
30-Nov-18,916,30-Nov-18,50,,"1,204,728.78",COMMISSION 000013181130133821000206527301 NIP TRANSFER COMMISSION FOR 000013181130133821000206527301 NIP IFO DBN/BOLA TITILAYO MATTEW REF:000013181130133821000206527301
30-Nov-18,916,30-Nov-18,2.5,,"1,204,726.28",VALUE ADDED TAX VAT ON NIP TRANSFER FOR 00001
30-Nov-18,918,30-Nov-18,"150,000.00",,"1,054,726.28",CASH WITHDRAWAL HILDA TWAKI
30-Nov-18,919,30-Nov-18,"1,000,000.00",,"54,726.28",CHEQUE DEPOSIT FRM MC ALISTER NIGERIA LIMITED TO 4BOYZ ENTERPRISE REF:214077333400010000001811301604
1-Dec-18,0,30-Nov-18,"8,551.98",,"46,174.30",ACCOUNT MAINTENANCE CHARGE
1-Dec-18,0,30-Nov-18,427.6,,"45,746.70",VALUE ADDED TAX
1-Dec-18,0,3-Dec-18,,"6,300.00","52,046.70","TRANSFER BETWEEN CUSTOMERS MBANKING - ANY Account Transfer from IBRU, EDESIRI ONATEJIROGHENE to MC ALISTER NIGERIA LIMITED"
1-Dec-18,0,3-Dec-18,,"45,520.00","97,566.70",TRANSFER BETWEEN CUSTOMERS via GAPS 636792750553185496-1   from ROMA FRUIT OF NATURE LIMITED to MC ALISTER NIGERIA LIMITED REF:228663996000086186510112181531
3-Dec-18,0,3-Dec-18,"18,000.00",,"79,566.70",COMMISSION FOR SWIFT TRANSFER GTB745451C/18/FTFX:745451FX TRF : MC ALISTER NIGERIA LIMITED/VALSTAR HOLLAND BV
3-Dec-18,0,3-Dec-18,900,,"78,666.70",VAT ON COMM FOR SWIFT TRANSFER GTB745451C/18/FTFX:745451FX TRF : MC ALISTER NIGERIA LIMITED/VALSTAR HOLLAND BV
3-Dec-18,0,3-Dec-18,"6,000.00",,"72,666.70",SWIFT/TELEX CHARGE GTB745451C/18/FTFX:745451FX TRF : MC ALISTER NIGERIA LIMITED/VALSTAR HOLLAND BV
3-Dec-18,0,3-Dec-18,"9,000.00",,"63,666.70",OVERSEAS BANK CHARGES GTB745451C/18/FTFX:745451FX TRF : MC ALISTER NIGERIA LIMITED/VALSTAR HOLLAND BV
3-Dec-18,774,3-Dec-18,,"524,580.00","588,246.70",CHEQUE DEPOSIT CHQ DEP FRM GOODISS SUPERSTORES LTD TO MC ALISTER NIGERIA LIMITED REF:206025054400005245801812031200
3-Dec-18,0,3-Dec-18,150,,"588,096.70",STAMP DUTY CHARGE 03122018 STAMP DUTY CHARGE - 03/12/2018
4-Dec-18,0,4-Dec-18,400,,"587,696.70",ONLINE STATEMENT CHARGE charge for 20 Pages Statement ifo MC ALISTER NIGERIA LIMITED/ 214/773334/1/1/0 REF:02147733340000000400181204165
4-Dec-18,0,4-Dec-18,20,,"587,676.70",VALUE ADDED TAX MC ALISTER NIGERIA LIMITED / 214
5-Dec-18,775,5-Dec-18,,"730,480.00","1,318,156.70",CHEQUE DEPOSIT CHQ DEP FRM GOODISS SUPERSTORES LTD TO MC ALISTER NIGERIA LIMITED REF:206025054400007304801812051216
5-Dec-18,0,5-Dec-18,50,,"1,318,106.70",STAMP DUTY CHARGE 05122018 STAMP DUTY CHARGE - 05/12/2018
6-Dec-18,921,6-Dec-18,"135,000.00",,"1,183,106.70",CLEARING WITHDRAWAL STER//CHQ//051218 ADESOKAN AND ADESOKAN Ref:GTC121477333411000000921000000
7-Dec-18,922,7-Dec-18,"1,100,000.00",,"83,106.70",CHEQUE DEPOSIT CHQ DEP IFO ASKOL NIG LTD FROM MC ALISTER NIGERIA LTD REF:214077333400011000001812071313
7-Dec-18,0,7-Dec-18,"18,000.00",,"65,106.70",COMMISSION FOR SWIFT TRANSFER GTB750346C/18/FTFX:750346FX TRF : MC ALISTER NIGERIA LIMITED/VALSTAR HOLLAND BV
7-Dec-18,0,7-Dec-18,900,,"64,206.70",VAT ON COMM FOR SWIFT TRANSFER GTB750346C/18/FTFX:750346FX TRF : MC ALISTER NIGERIA LIMITED/VALSTAR HOLLAND BV
7-Dec-18,0,7-Dec-18,"6,000.00",,"58,206.70",SWIFT/TELEX CHARGE GTB750346C/18/FTFX:750346FX TRF : MC ALISTER NIGERIA LIMITED/VALSTAR HOLLAND BV
7-Dec-18,0,7-Dec-18,"9,000.00",,"49,206.70",OVERSEAS BANK CHARGES GTB750346C/18/FTFX:750346FX TRF : MC ALISTER NIGERIA LIMITED/VALSTAR HOLLAND BV
8-Dec-18,0,10-Dec-18,,"7,200.00","56,406.70","TRANSFER BETWEEN CUSTOMERS MBANKING - ANY Account Transfer from IBRU, EDESIRI ONATEJIROGHENE to MC ALISTER NIGERIA LIMITED"
10-Dec-18,776,10-Dec-18,,"470,380.00","526,786.70",CHEQUE DEPOSIT CHQ DEP FRM GOODISS SUPERSTORES LTD TO MC ALISTER NIGERIA LIMITED REF:206025054400004703801812101205
10-Dec-18,0,10-Dec-18,,"9,500.00","536,286.70","TRANSFER BETWEEN CUSTOMERS MBANKING - ANY Account Transfer from IBRU, EDESIRI ONATEJIROGHENE to MC ALISTER NIGERIA LIMITED"
10-Dec-18,0,10-Dec-18,150,,"536,136.70",STAMP DUTY CHARGE 10122018 STAMP DUTY CHARGE - 10/12/2018
12-Dec-18,10092,12-Dec-18,,"2,458,365.00","2,994,501.70",CHEQUE DEPOSIT CHQ DEP IFO MC ALISTER NIGERIA LIMITED FRM HUBMART STORES LIMITED REF:209076906400024583651812121525
12-Dec-18,0,12-Dec-18,50,,"2,994,451.70",STAMP DUTY CHARGE 12122018 STAMP DUTY CHARGE - 12/12/2018
14-Dec-18,0,14-Dec-18,,"11,500.00","3,005,951.70","TRANSFER BETWEEN CUSTOMERS MBANKING - ANY Account Transfer from IBRU, EDESIRI ONATEJIROGHENE to MC ALISTER NIGERIA LIMITED"
14-Dec-18,925,14-Dec-18,"2,849,000.00",,"156,951.70",CHEQUE DEPOSIT CHQ DEP IFO 4BOYZ ENTERPRISE FRM MC ALISTER NIGERIA LIMITED REF:214077333400028490001812141741
14-Dec-18,0,14-Dec-18,"18,000.00",,"138,951.70",COMMISSION FOR SWIFT TRANSFER GTB755136C/18/FTFX:755136FX TRF : MC ALISTER NIGERIA LIMITED/VALSTAR HOLLAND BV
14-Dec-18,0,14-Dec-18,900,,"138,051.70",VAT ON COMM FOR SWIFT TRANSFER GTB755136C/18/FTFX:755136FX TRF : MC ALISTER NIGERIA LIMITED/VALSTAR HOLLAND BV
14-Dec-18,0,14-Dec-18,"6,000.00",,"132,051.70",SWIFT/TELEX CHARGE GTB755136C/18/FTFX:755136FX TRF : MC ALISTER NIGERIA LIMITED/VALSTAR HOLLAND BV
14-Dec-18,0,14-Dec-18,"9,000.00",,"123,051.70",OVERSEAS BANK CHARGES GTB755136C/18/FTFX:755136FX TRF : MC ALISTER NIGERIA LIMITED/VALSTAR HOLLAND BV
14-Dec-18,0,14-Dec-18,50,,"123,001.70",STAMP DUTY CHARGE 14122018 STAMP DUTY CHARGE - 14/12/2018
18-Dec-18,0,18-Dec-18,"5,400.00",,"117,601.70",COMMISSION FOR SWIFT TRANSFER GTB756563C/18/FTFX:756563FX TRF : MC ALISTER NIGERIA LIMITED/INTERNATIONAL FRESH PRODUCE FZE
18-Dec-18,0,18-Dec-18,270,,"117,331.70",VAT ON COMM FOR SWIFT TRANSFER GTB756563C/18/FTFX:756563FX TRF : MC ALISTER NIGERIA LIMITED/INTERNATIONAL FRESH PRODUCE FZE
18-Dec-18,0,18-Dec-18,"6,000.00",,"111,331.70",SWIFT/TELEX CHARGE GTB756563C/18/FTFX:756563FX TRF : MC ALISTER NIGERIA LIMITED/INTERNATIONAL FRESH PRODUCE FZE
18-Dec-18,0,18-Dec-18,"9,000.00",,"102,331.70",OVERSEAS BANK CHARGES GTB756563C/18/FTFX:756563FX TRF : MC ALISTER NIGERIA LIMITED/INTERNATIONAL FRESH PRODUCE FZE
19-Dec-18,0,19-Dec-18,"18,000.00",,"84,331.70",COMMISSION FOR SWIFT TRANSFER GTB758472C/18/FTFX:758472FX TRF : MC ALISTER NIGERIA LIMITED/SHAHIN ESTABLISHMENT FOR IMPORT AND EXPORT
19-Dec-18,0,19-Dec-18,900,,"83,431.70",VAT ON COMM FOR SWIFT TRANSFER GTB758472C/18/FTFX:758472FX TRF : MC ALISTER NIGERIA LIMITED/SHAHIN ESTABLISHMENT FOR IMPORT AND EXPORT
19-Dec-18,0,19-Dec-18,"6,000.00",,"77,431.70",SWIFT/TELEX CHARGE GTB758472C/18/FTFX:758472FX TRF : MC ALISTER NIGERIA LIMITED/SHAHIN ESTABLISHMENT FOR IMPORT AND EXPORT
19-Dec-18,0,19-Dec-18,"9,000.00",,"68,431.70",OVERSEAS BANK CHARGES GTB758472C/18/FTFX:758472FX TRF : MC ALISTER NIGERIA LIMITED/SHAHIN ESTABLISHMENT FOR IMPORT AND EXPORT
20-Dec-18,0,20-Dec-18,"12,194.93",,"56,236.77",COMMISSION FOR SWIFT TRANSFER GTB759396C/18/FTFX:759396FX TRF : MC ALISTER NIGERIA LIMITED/JITTU HORTICULTURE PLC
20-Dec-18,0,20-Dec-18,609.75,,"55,627.02",VAT ON COMM FOR SWIFT TRANSFER GTB759396C/18/FTFX:759396FX TRF : MC ALISTER NIGERIA LIMITED/JITTU HORTICULTURE PLC
20-Dec-18,0,20-Dec-18,"6,000.00",,"49,627.02",SWIFT/TELEX CHARGE GTB759396C/18/FTFX:759396FX TRF : MC ALISTER NIGERIA LIMITED/JITTU HORTICULTURE PLC
20-Dec-18,0,20-Dec-18,"9,000.00",,"40,627.02",OVERSEAS BANK CHARGES GTB759396C/18/FTFX:759396FX TRF : MC ALISTER NIGERIA LIMITED/JITTU HORTICULTURE PLC
21-Dec-18,13617307,21-Dec-18,,"50,000.00","90,627.02",CASH DEPOSIT PATIENCE UDOH
21-Dec-18,0,21-Dec-18,,"17,760.00","108,387.02",TRANSFER BETWEEN CUSTOMERS via GAPS 636809964961721621-1   from ROMA FRUIT OF NATURE LIMITED to MC ALISTER NIGERIA LIMITED REF:228663996000086186512112181341
21-Dec-18,0,21-Dec-18,"18,000.00",,"90,387.02",COMMISSION FOR SWIFT TRANSFER GTB760186C/18/FTFX:760186FX TRF : MC ALISTER NIGERIA LIMITED/VALSTAR HOLLAND B.V
21-Dec-18,0,21-Dec-18,900,,"89,487.02",VAT ON COMM FOR SWIFT TRANSFER GTB760186C/18/FTFX:760186FX TRF : MC ALISTER NIGERIA LIMITED/VALSTAR HOLLAND B.V
21-Dec-18,0,21-Dec-18,"6,000.00",,"83,487.02",SWIFT/TELEX CHARGE GTB760186C/18/FTFX:760186FX TRF : MC ALISTER NIGERIA LIMITED/VALSTAR HOLLAND B.V
21-Dec-18,0,21-Dec-18,"9,000.00",,"74,487.02",OVERSEAS BANK CHARGES GTB760186C/18/FTFX:760186FX TRF : MC ALISTER NIGERIA LIMITED/VALSTAR HOLLAND B.V
21-Dec-18,0,21-Dec-18,100,,"74,387.02",STAMP DUTY CHARGE 21122018 STAMP DUTY CHARGE - 21/12/2018
22-Dec-18,0,24-Dec-18,,"8,200.00","82,587.02","TRANSFER BETWEEN CUSTOMERS MBANKING - ANY Account Transfer from IBRU, EDESIRI ONATEJIROGHENE to MC ALISTER NIGERIA LIMITED"
24-Dec-18,0,24-Dec-18,50,,"82,537.02",STAMP DUTY CHARGE 24122018 STAMP DUTY CHARGE - 24/12/2018
27-Dec-18,39796267,28-Dec-18,,"350,000.00","432,537.02",CHECK DEPOSIT - TRANSIT DELIS SUPERMARKET & COFFEE SHOP
27-Dec-18,0,27-Dec-18,50,,"432,487.02",STAMP DUTY CHARGE 27122018 STAMP DUTY CHARGE - 27/12/2018
28-Dec-18,0,28-Dec-18,,"15,300.00","447,787.02",TRANSFER BETWEEN CUSTOMERS via GAPS 636815777861981198-1   from ROMA FRUIT OF NATURE LIMITED to MC ALISTER NIGERIA LIMITED REF:228663996000086186512812180710
28-Dec-18,926,28-Dec-18,"75,000.00",,"372,787.02",CHEQUE DEPOSIT FRM MC ALISTER NIG LTD TO QUALITY ZONE NIG LTD
28-Dec-18,39796266,31-Dec-18,,"350,000.00","722,787.02","CLEARING DEPOSIT, DR A/C IN LOCAL BRANCH FCMB|DELIS SUPERMARKET AND COFFEE SHOP Ref:OBC121477333411039796266000000"
28-Dec-18,6622,31-Dec-18,,"173,954.50","896,741.52","CLEARING DEPOSIT, DR A/C IN LOCAL BRANCH SKYE(POL)|MILAN INDUSTRIES LTD - EXPENSE ACCT Ref:OBC121477333411066220000000000"
28-Dec-18,795,31-Dec-18,,"173,954.50","1,070,696.02","CLEARING DEPOSIT, DR A/C IN LOCAL BRANCH SKYE(POL)|MILAN INDUSTRIES LTD - EXPENSE ACCT Ref:OBC121477333411079500000000000"
28-Dec-18,0,28-Dec-18,"9,000.00",,"1,061,696.02",COMMISSION FOR SWIFT TRANSFER GTB763984C/18/FTFX:763984FX TRF : MC ALISTER NIGERIA LIMITED/INTERNATIONAL FRESH PRODUCE FZE
28-Dec-18,0,28-Dec-18,450,,"1,061,246.02",VAT ON COMM FOR SWIFT TRANSFER GTB763984C/18/FTFX:763984FX TRF : MC ALISTER NIGERIA LIMITED/INTERNATIONAL FRESH PRODUCE FZE
28-Dec-18,0,28-Dec-18,"6,000.00",,"1,055,246.02",SWIFT/TELEX CHARGE GTB763984C/18/FTFX:763984FX TRF : MC ALISTER NIGERIA LIMITED/INTERNATIONAL FRESH PRODUCE FZE
28-Dec-18,0,28-Dec-18,200,,"1,055,046.02",STAMP DUTY CHARGE 28122018 STAMP DUTY CHARGE - 28/12/2018
31-Dec-18,927,31-Dec-18,"120,000.00",,"935,046.02",TRANSFER BETWEEN CUSTOMERS FRM MC ALISTER NIG LTD TO ADEBESHI MUSIBAU
1-Jan-19,0,31-Dec-18,"4,279.00",,"930,767.02",ACCOUNT MAINTENANCE CHARGE
1-Jan-19,0,31-Dec-18,213.95,,"930,553.07",VALUE ADDED TAX
